time_ms,temp_0,temp_1,temp_0_1,diff_p,abs_p,sfm3300
86.11,804,773,31,43,250,0.0
96.12,806,775,31,44,250,0.0
106.13,816,777,39,45,251,0.0
116.11,809,778,31,44,250,0.0
126.11,806,774,32,45,250,0.0
136.1,806,773,33,45,249,0.0
146.1,810,778,32,44,252,0.0
156.13,806,774,32,45,250,0.0
166.13,803,774,29,43,250,0.0
176.12,809,778,31,44,252,0.0
186.11,805,773,32,44,249,0.0
196.14,806,774,32,46,250,0.0
206.1,809,778,31,45,251,0.0
216.11,805,773,32,45,250,0.0
226.14,807,774,33,44,249,0.0
236.11,812,778,34,44,251,0.0
246.12,805,774,31,44,250,0.0
256.11,805,774,31,43,250,0.0
266.12,810,778,32,44,251,0.0
276.11,805,773,32,44,249,0.0
286.11,808,774,34,45,252,0.0
296.11,805,772,33,45,249,0.0
306.12,803,771,32,43,249,0.0
316.1,806,774,32,45,250,0.0
326.15,806,775,31,45,249,0.0
336.11,811,778,33,44,251,0.0
346.13,805,773,32,44,250,0.0
356.1,805,773,32,44,250,0.0
366.11,809,778,31,44,251,0.0
376.12,806,775,31,44,249,0.0
386.12,808,774,34,45,250,-0.0333
396.1,810,777,33,45,251,0.0
406.12,805,774,31,44,249,0.0
416.11,807,775,32,44,250,0.0
426.1,805,773,32,45,250,0.0
436.11,803,773,30,45,250,0.0
446.11,806,775,31,45,251,0.0
456.1,805,774,31,45,250,0.0
466.11,805,776,29,44,251,0.0
476.12,806,773,33,45,249,0.0
486.12,805,773,32,44,249,0.0
496.1,810,778,32,44,251,0.0
506.12,805,773,32,43,250,0.0
516.1,807,774,33,45,250,0.0
526.1,802,774,28,43,249,0.0
536.1,803,771,32,44,249,0.0
546.11,806,774,32,45,251,0.0
556.12,805,774,31,44,250,0.0
566.1,805,773,32,44,250,0.0
576.12,806,774,32,44,250,0.0
586.11,805,773,32,43,250,0.0
596.13,809,778,31,44,251,0.0
606.1,804,773,31,44,250,0.0
616.12,807,775,32,45,250,0.0
626.13,806,773,33,45,250,0.0
636.12,807,773,34,44,249,-0.0333
646.1,805,774,31,44,250,0.0
656.1,805,774,31,45,250,0.0
666.12,804,772,32,44,249,0.0
676.12,805,773,32,44,250,0.0
686.1,805,773,32,44,249,0.0
696.13,811,778,33,45,251,0.0
706.1,804,773,31,44,250,0.0
716.14,808,775,33,46,248,0.0
726.11,805,772,33,45,249,0.0
736.12,806,767,39,43,248,0.0
746.1,806,775,31,44,250,0.0
756.12,806,772,34,46,250,0.0
766.12,804,773,31,44,249,0.0
776.1,805,773,32,45,249,0.0
786.13,805,771,34,44,249,-0.0333
796.13,810,776,34,44,251,0.0
806.12,804,772,32,44,249,0.0
816.11,807,775,32,45,249,0.0
826.13,800,773,27,44,250,0.0
836.1,804,772,32,45,250,0.0
846.12,806,774,32,45,250,0.0
856.11,806,773,33,45,249,0.0
866.11,804,774,30,44,250,0.0
876.12,805,772,33,44,249,0.0
886.1,806,772,34,44,250,0.0
896.13,806,773,33,44,250,0.0
906.12,804,772,32,43,250,0.0
916.11,805,773,32,45,249,0.0
926.1,807,772,35,44,249,0.0
936.11,804,773,31,45,248,0.0
946.11,806,773,33,44,250,0.0
956.13,804,772,32,44,250,0.0
966.11,809,778,31,44,251,0.0
976.1,804,773,31,44,249,0.0
986.15,806,774,32,45,250,0.0
996.1,804,775,29,45,250,0.0
1006.11,804,774,30,45,249,0.0
1016.11,806,774,32,45,250,0.0
1026.11,806,773,33,45,249,0.0
1036.1,806,774,32,44,250,0.0
1046.13,805,774,31,44,249,0.0
1056.1,804,773,31,45,250,0.0
1066.1,809,777,32,44,250,0.0
1076.12,805,772,33,44,250,0.0
1086.11,806,774,32,45,249,0.0
1096.13,812,774,38,44,250,0.0
1106.1,806,772,34,45,250,0.0
1116.13,805,774,31,45,250,0.0
1126.1,806,773,33,45,249,0.0
1136.12,803,774,29,44,249,0.0
1146.13,805,773,32,44,250,0.0
1156.1,805,772,33,44,250,0.0
1166.12,810,778,32,45,251,0.0
1176.1,804,772,32,45,250,0.0
1186.15,804,772,32,45,250,0.0
1196.14,805,772,33,44,250,0.0
1206.12,804,772,32,44,249,0.0
1216.1,805,774,31,44,250,0.0
1226.1,807,774,33,45,250,0.0
1236.12,807,776,31,44,249,-0.0333
1246.11,805,775,30,45,249,0.0
1256.1,804,773,31,43,250,0.0
1266.13,810,778,32,44,251,0.0
1276.11,803,765,38,45,249,0.0
1286.13,806,771,35,45,249,0.0
1296.1,803,772,31,45,249,0.0
1306.11,803,772,31,45,250,0.0
1316.1,806,774,32,45,250,0.0
1326.14,803,773,30,45,249,0.0
1336.1,803,772,31,44,249,0.0
1346.11,805,774,31,45,250,0.0
1356.11,804,773,31,44,250,0.0
1366.12,810,775,35,44,250,0.0
1376.11,804,772,32,44,249,0.0
1386.13,806,774,32,44,250,0.0
1396.13,805,771,34,45,249,0.0
1406.1,804,772,32,44,250,0.0
1416.11,807,773,34,44,250,0.0
1426.1,807,773,34,44,250,0.0
1436.11,804,772,32,44,249,0.0
1446.1,805,772,33,45,249,-0.0333
1456.11,804,767,37,45,249,0.0
1466.13,809,778,31,45,251,0.0
1476.11,805,772,33,43,249,0.0
1486.11,806,775,31,45,250,0.0
1496.11,806,773,33,44,250,0.0
1506.12,804,772,32,45,250,0.0
1516.1,806,774,32,43,250,0.0
1526.11,801,773,28,42,249,0.0
1536.12,804,772,32,44,249,0.0
1546.1,803,772,31,45,249,0.0
1556.13,804,772,32,44,250,0.0
1566.1,807,774,33,44,250,0.0
1576.1,804,774,30,44,249,-0.0333
1586.11,806,774,32,45,250,0.0
1596.13,806,774,32,44,250,0.0
1606.1,805,773,32,43,250,0.0
1616.13,806,780,26,44,250,0.0
1626.1,804,772,32,44,250,0.0
1636.1,804,778,26,43,251,0.0
1646.1,802,770,32,45,250,0.0
1656.11,804,773,31,44,249,0.0
1666.13,805,772,33,45,249,0.0
1676.1,805,772,33,45,250,0.0
1686.11,806,773,33,46,250,0.0
1696.1,805,773,32,45,250,0.0
1706.11,803,772,31,44,250,0.0
1716.1,805,772,33,43,250,0.0
1726.12,804,767,37,43,248,0.0
1736.1,809,778,31,43,251,0.0
1746.12,805,773,32,44,249,0.0
1756.15,805,773,32,43,249,0.0
1766.12,805,771,34,46,249,0.0
1776.11,805,772,33,44,249,0.0
1786.12,806,772,34,45,250,0.0
1796.11,800,774,26,46,249,0.0
1806.11,805,772,33,44,250,0.0
1816.1,806,776,30,44,247,0.0
1826.11,805,773,32,44,250,0.0
1836.12,809,778,31,45,251,0.0
1846.1,803,772,31,45,249,0.0
1856.11,806,774,32,46,250,0.0
1866.11,804,772,32,46,249,0.0
1876.11,805,773,32,45,249,0.0
1886.13,806,774,32,43,253,0.0
1896.12,803,773,30,45,250,0.5
1906.12,803,768,35,55,251,9.9
1916.11,805,773,32,80,250,22.5333
1926.12,806,773,33,99,250,27.4667
1936.13,809,777,32,134,251,35.0
1946.12,805,772,33,176,249,42.9333
1956.11,806,773,33,219,250,50.6
1966.11,807,772,35,260,249,55.3667
1976.11,806,772,34,297,250,59.7
1986.12,806,773,33,321,250,62.8
1996.13,806,772,34,321,249,64.7667
2006.11,804,772,32,341,250,66.6333
2016.11,805,772,33,357,250,67.4
2026.11,805,773,32,357,249,69.2
2036.13,805,773,32,364,250,72.5667
2046.1,806,772,34,381,250,71.3
2056.11,805,772,33,359,250,71.5333
2066.11,806,774,32,374,250,69.5333
2076.12,803,773,30,376,250,71.7
2086.13,806,772,34,385,248,72.4333
2096.12,805,774,31,372,250,70.4
2106.11,810,779,31,356,252,73.3333
2116.11,807,775,32,376,249,72.2667
2126.11,805,774,31,385,250,73.7333
2136.13,804,773,31,370,250,69.7
2146.11,804,773,31,388,251,72.0
2156.13,806,774,32,393,249,72.5333
2166.13,806,774,32,364,250,70.7667
2176.11,802,768,34,381,252,72.3667
2186.13,806,774,32,371,250,73.4333
2196.11,806,774,32,377,250,72.2
2206.11,810,778,32,379,252,71.1667
2216.1,807,775,32,361,250,71.2667
2226.11,807,775,32,384,250,71.9333
2236.13,806,773,33,377,250,72.1
2246.11,805,773,32,384,250,74.3667
2256.14,805,775,30,386,251,72.4333
2266.11,814,775,39,381,250,73.4667
2276.12,805,772,33,380,250,73.3
2286.1,806,774,32,375,250,72.8333
2296.11,806,774,32,380,251,69.6667
2306.13,807,776,31,380,250,71.9
2316.1,805,773,32,383,249,74.4667
2326.11,808,775,33,388,250,71.5333
2336.12,801,774,27,389,250,73.0
2346.1,805,774,31,386,250,71.1
2356.12,803,776,27,368,250,71.4
2366.13,806,774,32,382,250,70.6
2376.11,804,772,32,380,250,73.1667
2386.11,806,773,33,386,251,71.9333
2396.11,806,774,32,390,250,73.0
2406.11,806,775,31,377,251,71.9333
2416.11,805,773,32,374,250,73.0333
2426.13,805,774,31,380,248,70.9667
2436.13,806,774,32,385,250,73.3667
2446.1,804,772,32,386,250,70.3667
2456.11,806,774,32,385,251,71.3667
2466.12,805,773,32,378,249,71.5667
2476.11,812,779,33,375,252,72.0
2486.1,805,774,31,388,250,72.0333
2496.11,808,775,33,381,251,71.0
2506.11,806,772,34,380,250,72.2
2516.1,805,773,32,372,250,72.3667
2526.1,805,775,30,387,251,71.0667
2536.11,806,775,31,374,250,71.7333
2546.12,805,773,32,372,251,75.9667
2556.1,805,774,31,391,250,72.5667
2566.11,804,774,30,383,249,71.2333
2576.11,811,778,33,392,252,71.9667
2586.1,804,773,31,385,250,70.5
2596.12,806,774,32,400,250,72.6333
2606.14,804,771,33,386,251,74.3667
2616.11,807,774,33,381,250,72.0667
2626.14,806,775,31,377,251,71.5333
2636.13,805,773,32,381,250,74.7333
2646.11,804,773,31,398,250,73.8667
2656.11,805,774,31,381,250,72.3667
2666.11,805,774,31,384,250,73.1333
2676.11,807,772,35,387,250,72.5667
2686.12,805,773,32,383,250,71.5
2696.11,806,775,31,373,250,75.2333
2706.13,807,775,32,359,250,73.7333
2716.12,805,771,34,370,248,70.7667
2726.11,806,775,31,379,250,73.9
2736.11,806,774,32,370,251,72.1667
2746.1,811,779,32,395,252,71.6333
2756.11,804,774,30,379,250,72.7333
2766.12,807,774,33,384,250,73.7333
2776.11,807,772,35,380,250,73.6
2786.12,805,773,32,395,250,70.9667
2796.14,807,775,32,383,251,72.6
2806.11,807,773,34,389,249,72.2667
2816.11,804,772,32,371,249,73.7667
2826.11,805,771,34,374,249,69.1333
2836.14,806,773,33,376,250,72.9333
2846.11,807,774,33,380,251,72.5667
2856.12,805,774,31,389,250,74.1
2866.12,806,776,30,384,250,72.1667
2876.11,808,774,34,375,250,72.7333
2886.1,807,774,33,383,251,74.5
2896.11,804,768,36,394,249,70.9333
2906.12,804,773,31,392,250,72.0667
2916.11,805,772,33,371,250,73.0333
2926.11,803,770,33,387,250,73.6667
2936.14,804,773,31,375,250,72.9667
2946.13,805,772,33,378,249,76.3
2956.12,804,772,32,388,250,69.4
2966.13,806,774,32,380,250,73.0667
2976.11,805,773,32,379,249,72.9667
2986.12,804,778,26,394,250,73.1667
2996.13,805,772,33,373,250,72.0
3006.12,805,773,32,390,251,72.0
3016.1,809,777,32,388,251,71.3
3026.11,802,772,30,396,250,71.9667
3036.14,806,774,32,377,250,70.2333
3046.14,804,773,31,382,249,72.5667
3056.14,804,773,31,379,249,72.6333
3066.12,805,774,31,385,250,70.6667
3076.11,805,774,31,385,250,71.7667
3086.1,803,772,31,378,250,71.5667
3096.11,806,772,34,383,250,73.6667
3106.13,805,773,32,380,250,70.6667
3116.11,809,778,31,379,252,72.7333
3126.11,803,773,30,390,250,76.8667
3136.11,805,774,31,387,250,75.8667
3146.14,803,772,31,383,250,73.7333
3156.12,805,772,33,395,250,74.0333
3166.13,805,775,30,386,250,73.0333
3176.11,803,773,30,381,250,72.7667
3186.11,804,772,32,389,250,72.4
3196.11,805,772,33,384,250,71.2333
3206.11,805,772,33,385,249,74.4333
3216.13,805,774,31,383,250,72.7
3226.12,805,773,32,385,250,70.8333
3236.11,806,774,32,375,250,70.2667
3246.13,806,773,33,387,249,72.6
3256.12,804,767,37,378,248,72.5667
3266.13,805,772,33,377,250,73.5
3276.11,803,773,30,365,250,72.7333
3286.11,809,777,32,388,251,72.6
3296.12,804,772,32,379,250,73.1667
3306.11,805,773,32,391,250,72.2333
3316.11,803,771,32,388,249,71.9
3326.11,804,771,33,370,250,72.6
3336.11,805,773,32,387,250,74.0667
3346.13,811,774,37,371,250,72.3
3356.11,803,772,31,374,250,72.4333
3366.12,805,773,32,387,250,71.6667
3376.13,804,773,31,379,249,70.9333
3386.12,809,777,32,386,251,73.3333
3396.12,804,772,32,376,250,75.3333
3406.11,805,775,30,379,250,71.0667
3416.11,806,768,38,377,249,73.3667
3426.1,807,773,34,376,250,75.8
3436.11,805,774,31,378,252,73.1667
3446.12,806,774,32,376,250,73.3667
3456.11,804,772,32,397,249,71.7667
3466.12,803,772,31,383,250,71.7
3476.11,804,773,31,382,250,72.3333
3486.13,805,772,33,387,250,72.8
3496.11,804,772,32,383,250,70.7333
3506.13,805,774,31,392,252,72.8333
3516.11,805,774,31,386,250,71.5333
3526.11,803,767,36,391,248,73.9333
3536.11,805,772,33,367,250,72.7667
3546.11,805,773,32,387,250,72.7333
3556.12,809,778,31,379,251,73.0333
3566.1,804,772,32,388,250,74.4
3576.12,806,774,32,382,250,71.5667
3586.11,804,772,32,385,249,72.7667
3596.1,803,772,31,371,250,71.0667
3606.13,805,774,31,380,251,71.8333
3616.13,807,774,33,386,250,75.0667
3626.11,804,772,32,386,250,72.6667
3636.11,805,772,33,386,250,71.5667
3646.14,804,771,33,380,250,71.9333
3659.25,801,768,33,391,248,73.1333
3666.11,804,772,32,387,250,74.8333
3676.11,804,774,30,389,250,72.1667
3686.14,807,773,34,386,249,69.9667
3696.13,806,773,33,391,250,73.8
3706.11,806,772,34,367,250,73.2333
3716.11,804,773,31,384,250,73.4333
3726.12,806,773,33,387,250,73.9667
3736.12,804,772,32,393,249,70.9667
3746.11,805,772,33,381,250,70.6
3756.14,804,771,33,370,249,72.7
3766.11,804,773,31,386,250,70.8
3776.13,804,774,30,395,249,73.6
3786.13,806,774,32,383,250,73.4
3796.11,804,767,37,396,247,74.7667
3806.13,805,773,32,391,250,71.2333
3816.11,805,772,33,392,250,74.9
3826.12,809,777,32,381,251,70.8333
3836.12,803,771,32,387,250,73.3333
3846.14,807,774,33,387,250,73.3667
3856.13,804,771,33,392,250,73.9333
3866.13,804,772,32,385,250,72.6
3876.13,805,774,31,379,250,72.7333
3886.13,812,773,39,373,250,72.7
3896.12,804,772,32,374,249,70.1333
3906.12,805,772,33,392,250,73.5667
3916.11,804,773,31,366,250,70.7
3926.14,805,773,32,367,249,72.2667
3936.12,804,773,31,341,249,70.1333
3946.13,806,774,32,343,251,68.0667
3956.11,805,773,32,296,249,64.1333
3966.12,805,774,31,254,250,59.1667
3976.11,803,774,29,213,251,51.9667
3986.13,805,773,32,163,250,45.7333
3996.1,805,772,33,126,250,40.0333
4006.12,803,772,31,101,250,33.1
4016.13,805,772,33,81,249,27.0
4026.11,805,772,33,65,249,21.0667
4036.11,804,772,32,53,249,16.0667
4046.11,804,774,30,49,250,11.1333
4056.11,805,774,31,45,249,7.2333
4066.1,805,771,34,45,247,3.8
4076.13,805,771,34,44,250,1.0
4086.13,804,771,33,45,249,-0.4333
4096.11,810,776,34,44,251,-0.7333
4106.12,803,772,31,45,249,-0.4
4116.14,805,774,31,45,249,0.1667
4126.14,805,772,33,43,249,0.5
4136.12,805,772,33,44,250,0.5667
4146.14,805,773,32,45,250,0.4
4156.13,805,773,32,45,250,0.1333
4166.12,804,772,32,45,250,-0.0667
4176.13,804,771,33,45,250,-0.1
4186.11,805,772,33,45,250,-0.0667
4196.14,803,772,31,44,249,0.0333
4206.1,803,772,31,45,249,0.1
4216.13,806,774,32,45,250,0.1333
4226.11,805,774,31,46,250,0.1
4236.1,803,771,32,45,249,0.0667
4246.12,805,774,31,45,249,0.0333
4256.13,804,772,32,45,249,0.0
4266.1,809,778,31,44,251,0.0
4276.12,807,774,33,44,250,0.0333
4286.11,806,775,31,46,250,0.0333
4296.13,805,772,33,45,249,0.0333
4306.12,803,773,30,43,250,0.0333
4316.13,805,773,32,45,252,0.0333
4326.13,806,774,32,43,249,0.0333
4336.12,804,767,37,45,248,0.0333
4346.12,805,773,32,44,249,0.0333
4356.12,803,772,31,43,249,0.0333
4366.11,807,777,30,45,251,0.0333
4376.11,802,772,30,45,248,0.0333
4386.11,806,774,32,46,249,0.0333
4396.13,805,772,33,43,249,0.0333
4406.11,803,773,30,43,250,0.0333
4416.1,805,774,31,45,250,0.0333
4426.11,803,771,32,45,247,0.0333
4436.12,804,773,31,45,249,0.0
4446.1,805,773,32,43,249,0.0333
4456.13,804,773,31,44,249,0.0333
4466.11,805,775,30,45,250,0.0333
4476.12,806,773,33,45,250,0.0333
4486.14,806,774,32,45,250,0.0
4496.14,806,774,32,44,251,0.0
4506.12,804,771,33,45,250,0.0333
4516.13,799,767,32,45,250,0.0333
4526.11,803,772,31,44,249,0.0
4536.11,809,777,32,44,251,0.0
4546.11,805,774,31,45,250,0.0333
4556.14,806,773,33,44,250,0.0
4566.11,804,773,31,44,250,0.0333
4576.12,803,772,31,45,250,0.0333
4586.11,804,771,33,44,251,0.0
4596.11,805,774,31,44,249,0.0
4606.1,804,767,37,44,247,0.0
4616.12,805,773,32,44,249,0.0
4626.11,803,773,30,43,250,0.0333
4636.13,809,777,32,45,251,0.0333
4646.1,804,772,32,44,250,0.0333
4656.13,806,775,31,45,250,0.0333
4666.11,803,772,31,43,249,0.0
4676.11,804,772,32,44,250,0.0
4686.12,806,774,32,44,250,0.0
4696.11,805,767,38,44,247,0.0
4706.11,803,772,31,45,249,0.0333
4716.12,806,772,34,45,249,0.0333
4726.11,804,773,31,44,249,0.0333
4736.11,806,774,32,45,249,0.0333
4746.11,805,773,32,43,250,0.0333
4756.11,805,773,32,45,250,0.0
4766.13,803,769,34,44,250,0.0
4776.12,806,772,34,44,250,0.0
4786.11,805,778,27,44,250,0.0
4796.12,804,773,31,45,250,0.0
4806.11,809,777,32,45,251,0.0
4816.11,806,773,33,45,250,0.0
4826.14,805,772,33,43,249,0.0
4836.14,804,771,33,45,249,0.0
4846.11,804,772,32,45,249,0.0
4856.11,805,774,31,46,250,0.0
4866.14,804,772,32,45,250,0.0
4876.12,806,774,32,44,250,0.0
4886.12,806,772,34,45,250,0.0
4896.11,804,772,32,44,249,0.0
4906.11,809,777,32,44,251,0.0333
4916.12,803,772,31,44,249,0.0
4926.13,805,775,30,45,249,0.0333
4936.13,804,771,33,44,250,0.0
4946.11,804,772,32,44,249,0.0333
4956.11,806,773,33,44,250,0.0
4966.12,799,773,26,44,248,0.0
4976.11,804,773,31,44,250,0.0
4986.11,807,774,33,45,249,0.0
4996.11,806,774,32,44,250,0.0
5006.14,807,774,33,44,250,0.0
5016.12,807,774,33,44,250,0.0
5026.11,805,774,31,45,250,0.0
5036.13,807,776,31,46,250,0.0
5046.11,806,774,32,44,250,0.0
5056.11,803,775,28,45,251,0.0
5066.11,805,773,32,44,250,0.0
5076.12,810,778,32,45,250,0.0
5086.11,804,772,32,45,250,0.0
5096.11,806,773,33,44,249,0.0
5106.13,805,772,33,46,249,0.0
5116.12,805,773,32,44,250,0.0
5126.13,807,771,36,45,251,0.0
5136.11,806,775,31,45,250,0.0333
5146.11,805,767,38,44,248,0.0
5156.11,806,774,32,44,250,0.0
5166.12,805,773,32,44,250,0.0
5176.11,811,778,33,46,251,0.0
5186.11,806,774,32,44,250,0.0
5196.11,807,774,33,44,250,0.0
5206.13,805,775,30,42,250,0.0
5216.12,805,773,32,45,250,0.0333
5226.13,807,774,33,45,250,0.0
5236.14,806,774,32,45,250,0.0
5246.11,806,773,33,45,249,0.0
5256.13,806,773,33,44,250,-0.0333
5266.12,806,773,33,44,249,0.0
5276.11,811,779,32,44,251,0.0
5286.11,804,773,31,44,250,0.0
5296.14,807,776,31,44,250,0.0
5306.14,806,772,34,44,250,0.0
5316.12,805,774,31,43,250,0.0
5326.11,801,780,21,45,247,0.0
5336.12,802,773,29,45,249,0.0
5346.11,805,773,32,45,250,0.0
5356.12,805,771,34,44,249,0.0
5366.14,805,774,31,44,250,0.0
5376.11,807,775,32,44,249,0.0
5386.11,805,773,32,44,250,0.0
5396.11,806,774,32,44,250,0.0
5406.11,807,773,34,43,249,0.0
5416.11,802,773,29,44,250,0.0
5426.13,807,774,33,45,251,0.0
5436.12,805,773,32,45,250,0.0
5446.12,810,778,32,43,250,0.0
5456.12,802,773,29,44,250,0.0
5466.11,807,773,34,45,250,0.0
5476.11,806,772,34,45,249,0.0
5486.1,805,774,31,45,250,0.0
5496.11,807,775,32,45,250,0.0
5506.13,806,774,32,45,250,0.0
5516.11,805,773,32,45,249,0.0
5526.14,806,774,32,45,249,0.0
5536.13,805,774,31,44,249,0.0
5546.1,810,778,32,45,251,0.0
5556.11,806,774,32,45,249,0.0
5566.14,807,773,34,44,249,0.0
5576.13,806,775,31,46,250,0.0
5586.12,805,773,32,44,250,0.0
5596.11,806,773,33,44,250,0.0
5606.13,806,774,32,44,250,0.0
5616.11,803,773,30,44,250,0.0
5626.11,805,774,31,44,250,0.0
5636.12,806,773,33,44,250,0.0
5646.12,810,779,31,45,251,0.0
5656.11,804,774,30,44,250,0.0
5666.11,799,770,29,46,249,0.0
5676.11,806,773,33,45,249,0.0
5686.1,805,774,31,45,250,0.0
5696.11,806,775,31,45,250,0.0
5706.11,806,775,31,44,249,0.0
5716.13,807,773,34,42,250,0.0
5726.1,805,773,32,45,250,0.0
5736.14,805,774,31,43,250,0.0
5746.13,810,779,31,43,252,0.0
5756.12,804,774,30,44,250,0.0
5766.12,805,775,30,45,251,0.0
5776.14,806,773,33,46,249,0.0
5786.12,805,774,31,45,250,0.0
5796.11,807,775,32,45,251,0.0
5806.13,806,771,35,44,249,0.0
5816.11,810,772,38,43,250,0.0
5826.1,806,772,34,44,250,0.0
5836.14,806,773,33,44,250,0.0
5846.11,805,772,33,44,251,0.0
5856.12,806,774,32,44,249,0.0
5866.11,805,775,30,45,250,0.0
5876.14,806,775,31,44,250,0.0
5886.12,804,772,32,44,250,0.0
5896.11,806,773,33,45,250,0.0
5906.12,805,773,32,44,250,0.0
5916.11,810,779,31,44,252,0.0
5926.1,806,774,32,44,249,0.0
5936.11,808,779,29,44,250,0.0
5946.11,805,773,32,44,250,0.0
5956.11,805,775,30,44,249,0.0
5966.14,807,773,34,44,250,0.0
5976.15,808,774,34,45,249,0.0
5986.12,807,774,33,45,250,0.0
5996.12,806,773,33,44,249,0.0
6006.11,804,773,31,43,250,0.0
6016.13,811,778,33,44,251,0.0
6026.11,804,773,31,43,250,0.0
6036.13,806,775,31,46,250,0.0
6046.11,807,771,36,45,248,0.0
6056.12,806,773,33,45,250,0.0
6066.11,807,774,33,45,250,0.0
6076.11,806,775,31,44,250,-0.0333
6086.12,805,773,32,44,250,0.0
6096.1,806,773,33,45,249,0.0
6106.13,805,773,32,44,249,0.0
6116.11,810,778,32,44,251,0.0
6126.12,804,773,31,44,250,0.0
6136.11,806,775,31,45,249,0.0
6146.13,806,774,32,44,249,0.0
6156.12,807,773,34,43,250,0.0
6166.13,805,775,30,45,250,0.0
6176.11,807,771,36,44,249,0.0
6186.11,805,773,32,44,250,0.0
6196.12,806,773,33,44,250,0.0
6206.13,805,773,32,44,248,0.0
6216.11,807,774,33,44,250,0.0
6226.12,807,773,34,44,250,0.0
6236.11,807,774,33,44,250,0.0
6246.11,807,776,31,45,250,0.0
6256.12,805,774,31,44,250,0.0
6266.11,806,775,31,45,250,0.0
6276.11,805,774,31,45,250,-0.0333
6286.12,804,772,32,43,249,0.0
6296.1,806,774,32,44,250,0.0
6306.12,805,774,31,43,250,0.0
6316.14,803,775,28,45,250,0.0
6326.11,805,773,32,45,250,0.0
6336.11,806,775,31,45,251,0.0
6346.14,805,773,32,46,250,0.0
6356.11,804,773,31,44,249,0.0
6366.13,807,774,33,45,250,0.0
6376.12,805,774,31,43,250,0.0
6386.12,810,778,32,45,252,0.0
6396.12,806,775,31,44,250,0.0
6406.12,807,775,32,44,249,0.0
6416.14,803,773,30,45,249,0.0
6426.11,806,774,32,45,250,0.0
6436.13,806,774,32,45,250,0.0
6446.13,808,774,34,46,249,0.0
6456.11,806,774,32,44,250,0.0
6466.11,804,773,31,44,249,0.0
6476.11,804,774,30,45,250,0.0
6486.12,810,778,32,45,252,0.0
6496.11,805,775,30,45,249,0.0
6506.13,806,775,31,47,250,0.0333
6516.11,805,773,32,45,250,0.0
6526.1,804,773,31,44,249,0.0
6536.13,807,775,32,44,250,0.0
6546.11,803,770,33,45,250,0.0
6556.12,804,773,31,45,249,0.0
6566.11,805,773,32,46,249,0.0
6576.14,805,774,31,44,250,0.0
6586.13,803,775,28,46,250,0.0
6596.11,805,773,32,44,250,0.0
6606.11,806,773,33,44,250,0.0
6616.11,805,775,30,45,250,0.0
6626.12,804,772,32,43,250,0.0
6636.11,806,775,31,44,251,0.0
6646.11,806,774,32,44,250,0.0
6656.1,810,778,32,43,250,0.0
6666.11,802,772,30,45,249,0.0
6676.11,806,774,32,44,250,0.0
6686.13,806,774,32,44,249,0.0
6696.1,805,773,32,44,250,0.0
6706.11,806,775,31,44,250,0.0
6716.13,809,774,35,46,250,0.0
6726.12,807,774,33,44,250,0.0
6736.12,807,775,32,45,251,0.0
6746.11,806,774,32,44,250,0.0
6756.1,810,778,32,44,251,0.0
6766.1,804,768,36,45,248,0.0
6776.15,806,773,33,43,250,0.0
6786.11,804,773,31,45,249,0.0
6796.1,805,773,32,45,250,0.0
6806.14,806,774,32,44,250,0.0
6816.13,803,774,29,45,250,0.0
6826.11,805,773,32,44,251,0.0
6836.13,806,774,32,44,249,0.0
6846.14,807,773,34,45,249,0.0
6856.11,805,772,33,43,248,0.0
6866.1,805,774,31,44,250,0.0
6876.15,808,775,33,45,250,0.0
6886.14,806,772,34,45,250,0.0
6896.12,806,773,33,43,250,0.0
6906.11,806,774,32,44,250,0.0
6916.11,808,774,34,45,250,0.0
6926.11,806,774,32,45,250,0.0
6936.13,806,773,33,45,250,0.0
6946.13,805,773,32,44,250,0.0
6956.1,810,779,31,44,252,0.0
6966.1,804,773,31,44,249,0.0
6976.12,807,775,32,45,250,0.0
6986.14,806,772,34,44,249,0.0
6996.11,806,773,33,44,250,0.0
7006.13,807,775,32,44,250,0.0
7016.11,803,772,31,45,249,0.0
7026.1,802,772,30,44,249,0.0
7036.12,803,773,30,45,250,0.0
7046.11,808,775,33,44,249,0.0
7056.1,804,772,32,45,249,0.0
7066.12,803,773,30,45,249,0.0
7076.11,807,773,34,44,250,0.0
7086.15,805,772,33,44,249,0.0
7096.12,802,772,30,44,249,0.0
7106.11,805,768,37,42,247,0.0
7116.1,803,771,32,45,250,0.0
7126.13,804,769,35,45,249,0.0
7136.11,803,771,32,44,250,0.0
7146.14,809,774,35,45,249,0.0
7156.14,805,772,33,45,249,0.0
7166.13,803,773,30,45,250,0.0
7176.11,805,772,33,45,250,0.0
7186.11,804,772,32,44,250,0.0
7196.11,803,773,30,44,250,0.0
7206.12,804,772,32,45,249,0.0
7216.13,805,775,30,44,249,0.0
7226.13,805,772,33,43,249,0.0
7236.11,804,771,33,44,250,0.0
7246.11,807,773,34,45,250,0.0
7256.11,806,773,33,45,250,0.0
7266.12,799,769,30,43,248,0.0
7276.11,806,771,35,45,250,0.0
7292.21,807,772,35,45,250,0.0
7296.11,804,772,32,45,249,0.0
7309.95,806,772,34,44,250,0.0
7316.13,804,775,29,44,250,0.0
7332.41,803,771,32,44,248,0.0
7336.11,803,769,34,44,249,0.0
7346.11,800,768,32,44,248,-0.0333
7356.11,804,773,31,43,249,0.0
7366.13,807,774,33,43,249,0.0
7376.12,802,771,31,44,249,0.0
7386.12,804,772,32,44,250,0.0
7396.14,803,776,27,43,252,0.0
7406.12,803,771,32,46,248,0.0
7416.12,803,774,29,44,249,0.0333
7426.12,805,774,31,45,249,0.0
7436.11,803,769,34,44,248,-0.0333
7446.11,805,774,31,45,249,0.0
7456.14,803,773,30,45,249,0.0
7466.12,803,773,30,45,250,0.0
7476.14,801,768,33,45,249,0.0
7486.11,802,772,30,45,248,0.0
7496.13,802,770,32,44,248,-0.0333
7506.12,799,767,32,44,249,0.0
7516.13,803,770,33,45,248,0.0
7526.11,804,773,31,43,249,0.0
7536.14,805,773,32,44,249,0.0
7546.14,800,768,32,45,248,0.0
7556.12,804,772,32,45,248,0.0
7566.12,803,772,31,44,250,0.0
7576.11,798,766,32,44,248,0.0
7586.12,804,773,31,45,250,0.0
7596.11,803,773,30,44,249,0.0
7606.14,806,775,31,45,250,0.0
7616.14,806,772,34,45,249,0.0
7626.12,804,774,30,43,250,0.0
7636.16,802,772,30,45,249,0.0
7646.11,804,773,31,45,249,0.0
7656.12,804,773,31,45,248,0.0
7666.14,806,767,39,45,251,0.0
7676.12,804,772,32,45,250,0.0
7686.11,805,772,33,45,249,0.0
7696.12,807,775,32,46,249,0.0
7706.13,806,771,35,44,249,0.0
7716.12,801,773,28,45,249,0.0
7726.11,802,771,31,43,250,0.0
7736.14,803,769,34,44,248,0.0
7746.12,803,772,31,45,249,0.0
7756.12,808,772,36,43,248,0.0
7766.12,804,772,32,44,249,0.0
7776.12,802,769,33,44,249,0.0
7786.11,802,769,33,45,249,0.0
7796.12,804,773,31,43,249,0.0
7806.14,802,774,28,44,249,0.0
7816.12,804,771,33,45,249,0.0
7826.14,799,767,32,45,249,0.0
7836.11,797,767,30,44,248,0.0
7846.12,799,770,29,44,250,0.0
7856.11,798,767,31,44,248,0.0
7866.12,803,773,30,45,249,0.0
7876.11,805,773,32,44,250,0.0
7886.14,803,770,33,44,249,0.0
7896.11,803,771,32,45,249,0.0
7906.11,804,771,33,43,249,0.0
7916.11,803,773,30,43,249,0.0
7926.11,802,772,30,44,250,0.0
7936.11,804,771,33,45,249,0.0
7946.11,804,772,32,45,249,0.0
7956.11,803,777,26,45,251,0.0
7966.12,803,771,32,44,249,0.0
7976.13,801,772,29,45,250,0.0
7986.14,803,771,32,45,249,0.0
7996.12,803,773,30,44,249,0.0
8006.13,804,773,31,45,251,0.0
8016.12,803,769,34,42,247,0.0
8026.11,802,772,30,45,249,0.0
8036.12,803,772,31,45,249,0.0
8046.11,803,771,32,46,249,-0.0333
8056.13,804,772,32,44,249,0.0
8066.11,804,772,32,43,249,0.0
8076.11,805,771,34,44,250,0.0
8086.14,804,772,32,44,249,0.0
8096.12,803,772,31,45,250,0.0
8106.11,804,772,32,44,249,0.0
8116.12,803,771,32,45,250,0.0
8126.1,809,776,33,44,251,0.0
8136.11,804,772,32,45,249,0.0
8146.11,806,770,36,45,249,0.0
8156.11,804,771,33,43,249,0.0
8166.1,803,772,31,44,249,0.0
8176.13,805,773,32,45,249,0.0
8186.13,806,767,39,45,250,0.0
8196.12,804,772,32,44,249,0.0
8206.11,806,776,30,44,250,0.0
8216.11,802,771,31,43,249,0.0
8226.12,808,776,32,43,250,0.0
8236.11,802,770,32,45,249,0.0
8246.11,805,774,31,45,250,0.0
8256.14,803,772,31,44,248,0.0
8266.12,802,771,31,44,249,0.0
8276.13,805,772,33,45,250,0.0
8286.1,803,771,32,44,250,0.0
8296.12,803,770,33,44,250,0.0
8306.11,803,772,31,44,249,0.0
8316.11,804,772,32,45,249,0.0
8326.13,805,771,34,45,249,0.0
8336.11,802,770,32,44,249,0.0
8346.11,805,772,33,46,250,0.0
8356.11,805,772,33,45,249,0.0
8366.1,804,771,33,44,249,0.0
8376.13,804,771,33,45,249,0.0
8386.1,799,772,27,45,250,0.0
8396.13,802,771,31,45,250,0.0
8406.11,802,772,30,44,249,0.0
8416.13,804,773,31,44,248,0.0
8426.14,804,771,33,45,249,0.0
8436.12,802,771,31,44,249,0.0
8446.11,804,772,32,43,249,0.0
8456.12,802,772,30,45,250,0.0
8466.12,800,770,30,45,249,0.0
8476.13,805,771,34,43,249,0.0
8486.15,803,773,30,44,249,0.0
8496.11,804,772,32,45,251,0.0
8506.11,803,771,32,43,249,0.0
8516.11,803,772,31,45,250,0.0
8526.11,805,772,33,44,249,-0.0333
8536.13,801,770,31,43,249,0.0
8546.11,807,776,31,44,251,0.0
8556.11,803,771,32,44,249,0.0
8566.13,805,773,32,45,250,-0.0333
8576.12,802,768,34,45,247,0.0
8586.11,803,770,33,45,248,0.0
8596.13,805,774,31,45,249,0.0
8606.13,798,767,31,45,249,0.0
8616.13,805,775,30,43,249,0.0
8626.11,803,772,31,43,249,0.0
8636.11,803,772,31,44,249,0.0
8646.11,799,769,30,45,248,0.0
8656.1,803,770,33,45,249,0.0
8666.14,804,770,34,44,249,0.0
8676.13,802,769,33,43,249,0.0
8686.14,799,771,28,45,249,0.0
8696.14,805,773,32,45,249,0.0
8706.13,805,773,32,45,249,0.0
8716.11,800,768,32,44,248,-0.0333
8726.11,802,773,29,45,249,0.0
8736.12,805,773,32,44,250,0.0
8746.14,798,762,36,43,247,0.0
8756.14,804,773,31,44,249,0.0
8766.11,804,772,32,46,250,0.0
8776.12,802,766,36,44,247,0.0
8786.15,799,767,32,44,248,0.0
8796.11,804,771,33,43,249,0.0
8806.15,804,773,31,44,249,0.0
8816.11,799,768,31,44,247,0.0
8826.11,802,772,30,44,249,0.0
8836.13,803,774,29,44,249,0.0
8846.11,803,771,32,44,249,0.0
8856.13,802,769,33,44,248,0.0
8866.11,805,774,31,45,249,0.0
8876.13,805,770,35,45,249,0.0
8886.11,800,768,32,44,247,0.0
8896.11,805,772,33,45,250,0.0
8906.12,803,773,30,45,249,0.0
8916.15,798,766,32,44,247,0.0
8926.14,806,768,38,44,251,0.0
8936.12,806,773,33,45,249,0.0
8946.14,803,770,33,45,248,0.0
8956.12,804,771,33,44,249,0.0
8966.12,805,773,32,44,249,0.0
8976.15,804,770,34,45,249,0.0
8986.11,804,771,33,44,250,0.0
8996.13,805,774,31,44,249,0.0
9006.13,804,768,36,43,248,0.0
9016.11,803,771,32,44,249,0.0
9026.12,804,771,33,43,250,0.0
9036.12,802,771,31,45,249,0.0
9046.13,804,772,32,44,249,0.0
9056.12,803,771,32,44,250,0.0
9066.11,803,773,30,44,249,0.0
9076.11,803,774,29,43,249,0.0
9086.11,804,771,33,45,248,0.0
9096.13,804,772,32,44,250,-0.0333
9106.11,804,773,31,44,249,0.0
9116.12,807,777,30,44,249,0.0
9126.11,800,769,31,44,250,0.0
9137.48,802,772,30,43,248,-0.0333
9146.11,804,769,35,45,249,0.0
9156.12,803,770,33,44,250,0.0
9166.11,806,773,33,44,249,0.0
9176.14,807,773,34,45,249,0.0
9186.12,803,771,32,44,250,0.0
9196.11,806,773,33,44,250,0.0
9206.12,805,774,31,45,249,0.0
9216.12,803,769,34,44,247,0.0
9226.12,809,778,31,44,251,0.0
9236.11,809,777,32,44,251,0.0
9246.12,804,772,32,44,250,0.0
9256.14,806,769,37,44,247,0.0
9266.11,798,767,31,44,248,0.0
9276.13,805,773,32,45,250,0.0
9286.13,804,773,31,47,250,0.0
9296.12,804,773,31,43,249,0.0
9306.11,807,774,33,45,250,0.0
9316.11,805,774,31,45,249,0.0
9326.11,804,772,32,44,249,0.0
9336.13,804,772,32,44,249,0.0
9346.12,805,773,32,44,250,0.0
9356.1,808,778,30,44,252,-0.0333
9366.11,805,773,32,44,250,0.0
9376.11,804,772,32,45,249,0.0
9386.13,803,771,32,43,249,0.0
9396.12,805,772,33,43,249,0.0
9406.14,805,773,32,44,250,0.0
9416.11,806,774,32,44,249,0.0
9426.12,804,774,30,44,249,0.0
9436.12,804,772,32,45,250,0.0
9446.12,804,773,31,44,250,0.0
9456.11,809,778,31,44,251,0.0
9466.13,810,772,38,45,249,-0.0333
9476.11,806,774,32,45,250,-0.0333
9486.13,804,772,32,46,249,0.0
9496.12,804,772,32,45,250,0.0
9506.11,805,773,32,45,249,0.0
9516.11,801,771,30,44,249,0.0
9526.12,804,772,32,45,250,0.0
9536.11,804,773,31,46,250,0.0
9546.12,803,773,30,44,250,0.0
9556.14,806,775,31,44,249,0.0
9566.11,805,773,32,45,250,0.0
9576.11,805,774,31,46,249,0.0
9586.14,804,774,30,45,249,0.0
9596.1,803,773,30,45,249,0.0
9606.13,806,773,33,44,249,0.0
9616.11,804,772,32,44,250,0.0
9626.11,809,777,32,44,251,0.0
9636.11,804,773,31,43,250,0.0
9646.47,806,773,33,43,249,0.0
9656.11,805,772,33,44,249,0.0
9666.11,804,772,32,44,249,0.0
9676.11,806,773,33,45,249,0.0
9686.11,805,774,31,46,249,0.0
9696.12,803,772,31,44,249,0.0
9706.12,803,771,32,44,249,0.0
9716.14,804,773,31,45,250,0.0
9726.14,805,773,32,43,248,0.0
9736.11,803,767,36,44,247,0.0
9746.12,806,775,31,46,250,0.0
9756.14,807,772,35,46,249,0.0
9766.1,804,772,32,45,249,0.0
9776.11,805,773,32,45,250,0.0
9786.11,805,770,35,43,248,0.0
9796.11,805,773,32,44,249,0.0
9806.12,806,773,33,44,250,0.0
9816.11,803,772,31,43,250,0.0
9826.13,807,772,35,44,251,0.0
9836.12,806,773,33,43,250,0.0
9846.11,807,774,33,44,251,0.0
9856.11,806,775,31,45,250,0.0
9866.11,807,774,33,44,249,0.0
9876.13,807,775,32,45,250,0.0
9886.11,805,773,32,44,249,0.0
9896.11,810,778,32,44,251,0.0
9906.11,804,770,34,44,250,0.0
9916.11,804,773,31,45,250,0.0
9926.14,805,775,30,44,249,0.0
9936.11,805,773,32,44,250,0.0
9946.14,806,774,32,45,250,0.0
9956.14,804,773,31,44,250,0.0
9966.11,804,773,31,44,249,0.0
9976.13,805,773,32,43,250,0.0
9986.12,805,774,31,43,249,0.0333
9996.1,810,779,31,44,251,0.0
10006.11,803,773,30,45,250,0.0
10016.11,807,774,33,44,249,0.0
10026.11,805,771,34,43,249,0.0
10036.12,804,773,31,43,250,0.0
10046.11,806,774,32,45,250,0.0
10056.14,805,774,31,45,250,0.0
10066.11,804,771,33,44,249,0.0
10076.12,806,767,39,46,250,0.0
10086.12,805,772,33,44,249,-0.0333
10096.1,810,775,35,44,249,0.0
10106.12,801,772,29,44,250,0.0
10116.12,805,772,33,44,250,0.0
10126.14,804,775,29,45,249,0.0
10136.11,803,771,32,45,249,0.0
10146.11,806,773,33,44,251,0.0
10156.13,803,773,30,45,249,0.0
10166.11,804,772,32,44,250,0.0
10176.11,806,771,35,44,249,0.0
10186.12,804,768,36,43,250,0.0
10196.11,810,778,32,43,250,0.0
10206.11,803,771,32,45,250,0.0
10216.12,805,775,30,45,249,0.0
10226.14,803,772,31,44,249,0.0
10236.12,803,771,32,44,250,0.0
10246.12,806,773,33,45,250,0.0
10256.12,807,775,32,43,250,0.0
10266.12,810,778,32,45,251,0.0
10276.12,808,776,32,45,248,0.0
10286.11,806,774,32,43,250,0.0
10296.11,810,779,31,44,251,0.0
10306.11,805,774,31,45,249,0.0
10316.14,806,774,32,45,250,0.0
10326.14,807,773,34,44,250,0.0
10336.12,807,775,32,44,249,0.0
10346.11,806,774,32,44,250,0.0
10356.11,805,774,31,45,250,0.0
10366.11,811,779,32,44,250,0.0
10376.11,805,773,32,45,250,0.0
10386.13,806,773,33,44,250,0.0
10396.11,810,779,31,45,252,0.0
10406.12,804,774,30,43,250,0.0
10416.11,804,774,30,45,250,0.0
10426.13,806,773,33,45,250,0.0
10436.12,805,774,31,44,250,0.0
10446.13,806,775,31,45,251,0.0
10456.11,807,781,26,44,250,0.0
10466.11,809,778,31,44,252,0.0
10476.12,807,774,33,45,250,0.0
10486.11,804,773,31,44,250,0.0
10496.11,810,778,32,44,251,0.0
10506.11,805,773,32,44,250,0.0
10516.11,806,773,33,45,250,0.0
10526.11,806,772,34,45,249,0.0
10536.11,805,773,32,44,250,0.0
10546.11,803,774,29,44,250,0.0
10556.11,804,774,30,44,250,0.0
10566.12,810,777,33,44,252,0.0
10576.11,807,771,36,44,249,0.0
10586.12,804,772,32,43,250,0.0
10596.11,805,775,30,45,250,0.0
10606.12,805,773,32,44,249,0.0
10616.13,806,771,35,45,248,-0.0333
10626.11,804,773,31,45,249,0.0
10636.11,805,774,31,45,250,0.0
10646.13,803,773,30,45,250,0.0
10656.11,803,773,30,44,249,0.0
10666.11,809,776,33,44,251,0.0
10676.11,804,772,32,44,249,0.0
10686.12,805,772,33,44,250,0.0
10696.11,809,776,33,46,252,0.0
10706.11,804,771,33,44,250,0.0
10716.13,805,774,31,45,250,0.0
10726.14,806,773,33,44,250,0.0
10736.1,804,771,33,44,250,0.0
10746.13,806,772,34,45,249,0.0
10756.11,804,771,33,45,250,0.0
10766.11,808,777,31,44,251,0.0
10776.11,804,774,30,43,250,0.0
10786.12,804,773,31,43,249,0.0333
10796.14,804,770,34,44,248,0.0
10806.11,803,771,32,45,250,0.0
10816.12,806,774,32,43,250,0.0
10826.13,805,772,33,45,250,0.0
10836.1,803,771,32,44,248,0.0
10846.11,805,773,32,43,249,0.0
10856.11,804,772,32,45,250,0.0
10866.14,809,777,32,45,251,0.0
10876.12,802,774,28,43,249,0.0
10886.13,804,772,32,46,250,0.0
10896.14,803,774,29,45,251,0.0
10906.11,807,772,35,44,249,0.0
10916.11,805,774,31,45,250,0.0
10926.14,805,771,34,45,249,0.0
10936.11,805,773,32,43,249,0.0
10946.11,807,772,35,45,250,0.0
10956.11,803,773,30,44,250,-0.0333
10966.11,810,778,32,43,251,0.0
10976.1,805,773,32,45,250,0.0
10986.11,804,773,31,44,250,0.0
10996.11,804,772,32,46,251,0.0
11006.11,804,773,31,44,250,0.0
11016.14,806,775,31,46,250,0.0
11026.14,806,774,32,46,250,0.0
11036.1,807,775,32,44,250,0.0
11046.11,806,775,31,45,250,0.0
11056.11,804,774,30,45,250,0.0
11066.11,809,778,31,44,252,0.0
11076.11,805,773,32,44,250,0.0
11086.13,810,773,37,43,249,-0.0333
11096.11,807,778,29,45,251,0.0
11106.1,804,772,32,45,250,0.0
11116.13,806,774,32,45,250,0.0
11126.15,806,771,35,43,249,0.0
11136.11,807,774,33,44,249,0.0
11146.13,805,772,33,45,250,0.0
11156.13,803,771,32,44,249,0.0
11166.11,810,778,32,44,251,0.0
11176.12,805,772,33,43,249,0.0
11186.13,806,772,34,44,249,0.0
11196.11,806,778,28,45,251,-0.0333
11206.12,805,772,33,45,250,0.0
11216.11,804,774,30,44,249,0.0
11226.11,805,771,34,45,250,0.0
11236.11,802,772,30,44,250,0.0
11246.13,804,774,30,44,249,0.0
11256.11,803,773,30,44,249,0.0
11266.12,809,777,32,44,251,0.0333
11276.12,804,773,31,44,249,0.0
11286.13,806,773,33,45,250,0.0
11296.11,805,771,34,45,249,0.0
11306.1,803,772,31,43,249,0.0
11316.12,805,773,32,44,251,0.0
11326.14,806,773,33,44,249,0.0
11336.11,805,772,33,45,249,0.0
11346.11,805,772,33,45,249,0.0
11356.12,803,773,30,45,250,0.0
11366.11,809,778,31,45,251,0.0
11376.12,804,772,32,44,249,-0.0333
11386.13,806,774,32,45,250,0.0
11396.13,804,771,33,45,249,-0.0333
11406.12,804,772,32,45,249,0.0
11416.13,804,774,30,45,250,0.0
11426.11,804,774,30,45,251,0.0
11436.12,804,773,31,44,249,0.0
11446.11,803,773,30,44,249,0.0
11456.12,802,769,33,43,248,0.0
11466.1,809,778,31,44,250,0.0
11476.11,804,771,33,43,250,0.0
11486.1,804,774,30,43,249,0.0
11496.14,804,771,33,45,249,0.0
11506.12,804,772,32,44,249,0.0
11516.13,804,775,29,45,250,0.0
11526.13,807,774,33,44,250,0.0
11536.12,803,767,36,44,248,0.0
11546.11,805,773,32,44,249,0.0
11556.13,805,774,31,45,249,0.0
11566.1,808,778,30,44,251,0.0
11576.12,804,771,33,43,249,0.0333
11586.11,805,773,32,43,251,-0.0333
11596.11,805,771,34,44,249,0.0
11606.12,807,772,35,44,250,0.0
11616.11,806,773,33,44,250,0.0
11626.12,811,774,37,44,249,0.0
11636.12,808,778,30,44,251,0.0
11646.11,803,773,30,44,249,0.0
11656.1,803,773,30,45,249,0.0
11666.12,809,778,31,46,251,0.0
11676.12,803,772,31,44,250,0.0
11686.11,806,774,32,46,250,0.0
11696.11,807,773,34,45,250,0.0
11706.11,804,775,29,45,249,0.0
11716.11,804,773,31,43,250,0.0
11726.12,805,773,32,43,249,0.0
11736.11,808,778,30,44,252,0.0
11746.12,804,771,33,45,249,0.0
11756.13,801,771,30,45,248,0.0
11766.14,803,771,32,43,248,0.0
11776.11,807,770,37,43,250,-0.0333
11786.14,805,773,32,45,251,0.0
11796.12,804,774,30,43,248,0.0
11806.12,808,775,33,43,250,0.0
11816.12,804,771,33,44,250,0.0
11826.12,806,773,33,45,250,0.0
11836.14,804,772,32,45,249,0.0
11846.1,804,773,31,44,249,0.0
11856.12,804,774,30,43,250,0.0
11866.11,804,772,32,43,249,0.0
11876.13,806,773,33,45,249,0.0
11886.12,804,772,32,43,250,0.0
11896.13,807,772,35,44,250,0.0
11906.12,805,772,33,46,249,0.0
11916.34,808,778,30,44,251,0.0
11926.11,805,773,32,45,249,0.0
11936.13,805,772,33,44,250,0.0
11946.11,804,774,30,44,250,0.0
11956.1,802,771,31,45,250,0.0
11966.11,806,773,33,44,250,0.0
11976.11,805,773,32,44,249,0.0
11986.11,804,767,37,45,247,0.0
11996.13,806,772,34,44,250,0.0
12006.13,803,772,31,45,249,0.0
12016.11,809,777,32,44,251,0.0
12026.11,806,773,33,45,249,0.0
12036.13,804,771,33,44,249,0.0
12046.14,805,777,28,45,251,0.0
12056.11,805,771,34,44,250,0.0
12066.13,807,772,35,45,250,-0.0333
12076.11,805,773,32,45,249,0.0
12086.11,804,771,33,43,250,0.0
12096.14,805,772,33,44,249,0.0
12106.1,803,772,31,44,249,0.0
12116.1,810,777,33,45,251,0.0
12126.11,806,770,36,44,250,0.0
12136.13,804,772,32,43,250,0.0
12146.14,803,774,29,44,250,0.0
12156.12,802,771,31,45,249,0.0
12166.11,802,780,22,44,250,0.0
12176.11,806,771,35,45,249,0.0
12186.12,804,772,32,44,249,0.0
12196.11,805,771,34,44,249,0.0
12206.13,806,772,34,44,250,0.0
12216.1,810,776,34,44,251,0.0
12226.12,803,771,32,44,250,0.0
12236.13,805,773,32,43,249,0.0
12246.11,803,773,30,45,249,0.0
12256.13,796,771,25,44,249,0.0
12266.11,806,773,33,44,250,0.0
12276.14,804,773,31,45,249,0.0
12286.1,804,770,34,44,250,0.0
12296.11,805,772,33,44,249,0.0
12306.13,803,772,31,44,249,0.0
12316.1,811,776,35,45,251,0.0
12326.11,803,772,31,43,249,0.0
12336.13,805,775,30,44,250,-0.0333
12346.13,805,772,33,46,249,0.0
12356.12,804,773,31,45,249,0.0
12366.14,806,774,32,45,250,0.0
12376.14,806,774,32,45,251,0.0
12386.12,803,774,29,44,250,0.0
12396.13,805,774,31,44,249,0.0
12406.12,805,772,33,44,250,0.0
12416.1,810,778,32,45,252,0.0
12426.11,803,773,30,44,250,0.0
12436.11,802,773,29,44,249,0.0
12446.11,807,774,33,44,249,0.0
12456.11,804,773,31,43,250,0.0
12466.13,806,774,32,45,251,0.0
12476.14,805,774,31,45,250,0.0
12486.1,804,774,30,43,250,0.0
12496.13,807,773,34,44,249,0.0
12506.13,806,773,33,45,250,0.0
12516.11,810,778,32,45,251,0.0
12526.11,808,773,35,45,249,0.0
12536.11,805,771,34,45,249,0.0
12546.11,807,772,35,45,250,0.0
12556.12,805,773,32,44,249,0.0
12566.11,806,774,32,45,250,-0.0333
12576.11,806,774,32,44,249,0.0
12586.12,804,774,30,45,250,0.0
12596.11,807,775,32,44,249,0.0
12606.11,805,773,32,43,250,0.0
12616.11,809,778,31,45,251,0.0
12626.12,804,773,31,45,249,0.0
12636.13,805,774,31,45,250,0.0
12646.11,806,775,31,43,249,0.0
12656.11,804,773,31,44,250,0.0
12666.11,806,775,31,46,251,0.0
12676.14,806,774,32,45,250,0.0
12686.11,804,773,31,45,250,0.0
12696.13,807,773,34,45,250,0.0
12706.12,806,773,33,43,251,0.0
12716.11,809,778,31,44,251,0.0
12726.11,805,773,32,44,250,0.0
12736.11,805,774,31,45,250,0.0
12746.11,807,773,34,44,249,0.0
12756.11,804,772,32,45,250,0.0
12766.11,807,774,33,44,250,0.0
12776.12,806,780,26,46,251,0.0
12786.11,804,772,32,44,249,0.0
12796.12,805,773,32,43,250,0.0
12806.11,806,774,32,44,250,0.0
12816.11,810,777,33,45,251,0.0
12826.1,804,773,31,45,250,0.0
12836.14,806,775,31,45,250,0.0
12846.14,804,773,31,43,251,0.0
12856.12,806,774,32,44,250,0.0
12866.13,807,769,38,46,250,0.0
12876.12,805,775,30,46,249,0.0
12886.12,806,775,31,44,249,0.0
12896.11,808,772,36,45,250,0.0
12906.12,806,774,32,44,250,0.0
12916.12,810,778,32,44,251,0.0
12926.1,804,773,31,46,250,0.0
12936.13,805,775,30,45,250,0.0
12946.11,808,775,33,45,250,0.0
12956.11,804,772,32,45,250,0.0
12966.11,806,775,31,44,249,0.0
12976.11,806,773,33,45,249,0.0
12986.11,810,778,32,45,251,0.0
12996.11,805,774,31,44,250,0.0
13006.11,805,773,32,43,249,-0.0333
13016.11,807,778,29,45,251,0.0
13026.12,804,773,31,43,250,0.0
13036.11,806,774,32,44,250,0.0
13046.13,800,774,26,45,249,0.0
13056.1,806,776,30,44,250,0.0
13066.13,803,775,28,45,250,0.0
13076.13,804,774,30,46,249,0.0
13086.55,809,778,31,44,249,-0.0333
13096.11,807,771,36,44,249,0.0
13106.11,806,774,32,44,249,0.0
13116.11,805,772,33,43,249,0.0
13126.12,805,773,32,45,249,0.0
13136.13,805,774,31,45,250,0.0
13146.14,805,772,33,44,249,0.0
13156.11,809,772,37,45,249,0.0
13166.11,804,773,31,45,249,0.0
13176.11,804,772,32,44,250,0.0
13186.11,805,773,32,43,250,0.0
13196.11,806,774,32,43,250,0.0
13206.11,805,775,30,44,249,0.0
13216.13,805,773,32,44,249,0.0
13226.11,804,773,31,43,250,0.0
13236.14,806,773,33,44,250,0.0
13246.13,809,773,36,44,249,0.0
13256.11,804,772,32,45,250,0.0
13266.13,804,772,32,45,249,0.0
13276.12,803,771,32,44,250,0.0
13286.12,808,777,31,44,251,0.0
13296.11,805,773,32,45,249,0.0
13306.11,804,774,30,43,250,0.0
13316.11,804,768,36,43,249,0.0
13326.11,803,773,30,45,249,0.0
13336.11,804,775,29,43,249,0.0
13346.14,805,772,33,44,248,0.0
13356.12,803,772,31,43,250,0.0
13366.12,804,772,32,45,250,0.0
13376.11,805,771,34,43,250,0.0
13386.23,808,777,31,44,251,0.0
13396.12,803,773,30,44,249,0.0
13406.12,806,773,33,44,249,0.0
13416.11,804,772,32,44,249,0.0
13426.11,800,772,28,44,250,0.0
13436.13,806,774,32,45,250,0.0
13446.13,804,771,33,45,250,0.0
13456.11,803,771,32,44,250,0.0
13466.12,804,772,32,43,249,0.0
13476.12,803,771,32,44,250,0.0
13486.11,808,777,31,44,251,0.0
13496.11,803,772,31,44,249,0.0
13506.11,806,773,33,46,251,0.0
13516.11,802,775,27,45,250,0.0
13526.1,805,774,31,43,250,0.0
13536.13,805,773,32,46,250,0.0
13546.12,805,772,33,45,250,0.0
13556.12,809,775,34,44,250,0.0
13566.12,804,772,32,44,249,0.0
13576.12,803,772,31,44,250,0.0
13586.12,809,778,31,45,251,0.0
13596.11,803,772,31,44,249,-0.0333
13606.11,801,779,22,46,249,-0.0333
13616.14,806,773,33,45,249,0.0
13626.12,807,775,32,45,250,0.0
13636.13,806,774,32,45,251,0.0
13646.1,806,774,32,45,250,0.0
13656.11,810,778,32,44,251,0.0
13666.11,805,773,32,43,250,0.0
13676.12,805,773,32,44,250,0.0
13686.11,808,777,31,45,250,0.0
13696.11,809,771,38,45,249,0.0
13706.12,805,773,32,44,250,0.0
13716.11,806,773,33,44,249,0.0
13726.11,805,772,33,44,250,0.0
13736.11,804,772,32,44,249,0.0
13746.45,799,769,30,45,249,0.0
13756.1,806,773,33,44,249,0.0
13766.11,804,773,31,45,250,0.0
13776.1,801,769,32,43,247,0.0
13786.11,802,775,27,45,250,0.0
13796.12,804,774,30,45,249,0.0
13806.11,803,773,30,45,250,0.0
13816.1,804,772,32,43,249,0.0
13826.11,805,774,31,46,250,0.0
13836.15,805,772,33,45,249,0.0
13846.11,806,773,33,45,250,-0.0333
13856.12,806,773,33,43,249,0.0
13866.12,806,773,33,44,250,0.0
13876.13,799,767,32,45,249,0.0
13886.12,806,770,36,45,250,0.0
13896.13,802,773,29,44,249,0.0
13906.11,806,769,37,46,249,0.0
13916.13,803,772,31,44,249,0.0
13926.12,803,772,31,45,250,0.0
13936.11,805,771,34,44,249,0.0
13946.12,804,773,31,44,249,0.0
13956.12,806,773,33,45,250,0.0
13966.12,800,771,29,43,250,-0.0333
13976.13,801,770,31,44,248,0.0
13986.12,805,773,32,44,249,0.0
13996.12,804,773,31,45,249,0.0
14006.11,802,773,29,44,249,0.0333
14016.13,805,774,31,43,249,0.0
14026.14,804,767,37,44,247,0.0
14036.12,803,773,30,44,249,0.0
14046.11,805,772,33,46,250,0.0
14056.11,800,768,32,44,251,0.0
14066.11,802,768,34,44,247,0.0
14076.12,804,773,31,45,249,0.0
14086.13,805,774,31,45,250,0.0
14096.11,798,767,31,44,247,0.0
14106.12,803,774,29,44,250,0.0
14116.13,805,773,32,44,249,0.0
14126.12,804,773,31,44,250,0.0
14136.11,801,768,33,44,249,0.0
14146.11,804,773,31,45,250,0.0
14156.13,801,770,31,45,248,0.0
14166.13,798,771,27,44,248,0.0
14176.12,805,772,33,44,250,0.0
14186.11,806,774,32,45,250,0.0
14196.12,806,772,34,45,249,0.0
14206.32,805,770,35,43,248,0.0
14216.11,803,773,30,44,249,0.0
14226.12,804,773,31,45,249,0.0
14236.14,796,766,30,46,248,0.0
14246.12,807,774,33,43,249,0.0
14256.13,806,774,32,45,249,0.0
14266.13,803,769,34,45,248,0.0
14276.11,803,772,31,45,249,0.0
14286.11,806,773,33,45,250,0.0
14296.11,804,772,32,45,250,0.0
14306.12,805,773,32,44,250,0.0
14316.13,806,775,31,45,250,0.0
14326.12,805,773,32,45,249,0.0
14336.11,802,770,32,44,250,0.0
14346.12,802,773,29,44,250,0.0
14356.12,803,771,32,44,249,0.0
14366.1,798,769,29,43,247,0.0
14376.13,805,771,34,43,249,0.0
14386.11,804,773,31,43,249,0.0
14396.11,804,774,30,44,249,0.0
14406.13,799,767,32,44,247,0.0
14416.14,807,768,39,44,249,0.0
14426.11,803,774,29,44,249,0.0
14436.13,800,768,32,43,248,0.0
14446.1,802,771,31,45,250,0.0
14456.11,803,772,31,44,249,0.0
14466.11,805,774,31,44,250,0.0
14476.11,800,768,32,45,248,0.0
14486.13,806,773,33,44,251,0.0
14496.11,803,774,29,44,249,0.0
14506.12,808,772,36,45,249,0.0
14516.11,803,774,29,43,249,0.0
14526.12,804,773,31,44,249,0.0
14536.12,808,777,31,44,251,0.0
14546.11,804,772,32,44,249,0.0
14556.1,803,772,31,44,249,0.0
14566.13,808,777,31,45,251,0.0
14576.12,804,773,31,44,249,0.0
14586.11,805,774,31,45,249,0.0333
14596.11,802,773,29,43,249,0.0
14606.11,806,773,33,45,249,0.0
14616.11,804,773,31,44,249,0.0
14626.11,804,772,32,44,248,0.0
14636.13,804,771,33,44,250,0.0
14646.1,803,773,30,44,249,0.0
14656.12,805,773,32,44,250,0.0
14666.12,804,773,31,44,250,0.0
14676.13,802,771,31,43,247,0.0
14686.13,801,768,33,45,250,0.0
14696.1,807,774,33,44,250,0.0
14706.14,802,770,32,46,249,0.0
14716.11,802,767,35,44,247,0.0
14726.13,806,773,33,44,249,0.0
14736.11,803,772,31,44,250,0.0
14746.15,800,769,31,44,248,0.0
14756.11,803,772,31,45,249,0.0
14766.11,807,773,34,45,250,0.0
14776.14,799,767,32,43,247,0.0
14786.11,804,772,32,45,249,0.0
14796.1,802,773,29,45,249,0.0
14806.11,809,778,31,44,251,0.0
14816.1,804,772,32,44,249,0.0
14826.12,805,774,31,45,250,0.0
14836.14,803,772,31,44,249,0.0
14846.1,807,774,33,44,249,0.0
14856.11,805,772,33,44,250,0.0
14866.12,810,773,37,43,249,0.0
14876.1,806,774,32,45,248,0.0333
14886.11,803,771,32,44,248,0.0
14896.13,806,774,32,45,250,0.0
14906.14,804,774,30,47,250,0.0
14916.13,797,768,29,45,247,0.0
14926.11,804,774,30,44,249,0.0
14936.13,806,773,33,44,249,0.0
14946.11,804,774,30,44,250,0.0
14956.1,809,780,29,45,250,0.0
14966.11,804,771,33,45,250,0.0
14976.13,806,774,32,45,250,0.0
14986.15,799,768,31,44,248,0.0
14996.13,806,772,34,45,250,0.0
15006.12,804,773,31,44,249,0.0
15016.1,804,772,32,45,249,0.0
15026.13,806,767,39,45,249,0.0
15036.11,803,772,31,44,249,0.0
15046.1,809,778,31,44,251,0.0
15056.1,804,771,33,44,249,0.0
15066.11,806,773,33,44,249,0.0
15076.11,805,771,34,45,249,0.0
15086.12,800,767,33,44,248,0.0
15096.11,808,773,35,44,250,0.0
15106.12,806,771,35,45,249,0.0
15116.1,804,772,32,44,249,0.0
15126.12,805,772,33,44,250,0.0
15136.12,804,769,35,44,250,0.0
15146.11,809,778,31,44,251,0.0
15156.12,805,771,34,44,249,0.0
15166.13,805,774,31,45,249,0.0
15176.14,803,772,31,44,249,0.0
15186.12,801,769,32,44,249,0.0
15196.14,806,772,34,45,250,0.0
15206.13,804,772,32,43,249,0.0
15216.12,810,778,32,44,250,-0.0333
15226.12,806,768,38,44,248,0.0
15236.11,806,772,34,44,249,0.0
15246.11,804,771,33,44,250,0.0
15256.11,805,772,33,45,249,0.0
15266.11,804,774,30,44,250,0.0
15276.13,805,772,33,45,250,0.0
15286.11,804,772,32,44,249,0.0
15296.13,805,766,39,44,249,0.0
15306.13,805,771,34,44,249,0.0
15316.11,810,777,33,45,251,0.0
15326.1,803,771,32,43,250,0.0
15336.11,805,774,31,45,249,0.0
15346.13,804,772,32,45,249,0.0
15356.12,803,771,32,44,250,0.0
15366.13,805,772,33,44,250,0.0
15376.12,804,773,31,45,249,0.0
15386.12,803,770,33,44,250,0.0
15396.13,806,771,35,44,249,0.0
15406.12,805,773,32,44,250,-0.0333
15416.11,809,776,33,45,251,0.0333
15426.12,803,772,31,45,250,0.0
15436.11,803,773,30,46,249,0.0
15446.11,803,772,31,45,248,0.0
15456.11,803,772,31,44,250,-0.0333
15466.12,804,774,30,44,249,0.0
15476.11,805,771,34,44,250,0.0
15486.11,804,772,32,44,250,0.0
15496.11,804,775,29,43,249,0.0
15506.11,805,772,33,44,249,0.0
15516.11,805,773,32,44,250,0.0
15526.11,806,772,34,44,250,0.0
15536.12,803,771,32,44,249,0.0
15546.11,805,773,32,45,250,0.0
15556.11,804,773,31,45,249,0.0
15566.11,808,777,31,44,251,0.0
15576.12,804,772,32,44,249,0.0
15586.11,802,776,26,45,250,0.0
15596.11,804,773,31,44,249,0.0
15606.12,805,773,32,44,250,0.0
15616.11,806,775,31,46,250,0.0
15626.11,806,775,31,45,250,0.0
15636.11,804,772,32,45,250,0.0
15646.11,806,773,33,45,250,0.0
15656.11,807,774,33,44,249,0.0
15666.14,805,772,33,44,249,0.0
15676.11,803,773,30,45,250,0.0
15686.11,806,775,31,45,250,0.0
15696.13,806,772,34,45,249,0.0
15706.11,806,773,33,44,249,-0.0333
15716.13,807,774,33,45,249,0.0
15726.12,806,774,32,45,249,0.0
15736.12,806,773,33,44,250,0.0
15746.11,805,773,32,45,249,0.0
15756.12,805,774,31,44,250,0.0
15766.11,807,778,29,43,251,0.0
15776.12,805,772,33,45,250,0.0
15786.13,806,774,32,45,250,0.0
15796.14,804,773,31,44,249,0.0
15806.11,803,772,31,44,249,0.0
15816.11,804,772,32,45,249,0.0
15826.13,806,774,32,43,250,0.0
15836.11,807,773,34,44,249,0.0
15846.11,806,774,32,44,250,0.0
15856.11,806,775,31,45,250,0.0
15866.12,805,774,31,44,250,0.0
15876.11,810,779,31,45,251,0.0
15886.11,804,774,30,43,250,0.0
15896.13,806,773,33,44,250,0.0
15906.13,806,777,29,44,251,0.0333
15916.12,803,772,31,43,249,0.0
15926.13,804,773,31,47,250,0.0
15936.14,803,772,31,44,249,0.0
15946.11,798,774,24,44,250,0.0
15956.11,804,774,30,44,250,0.0
15966.11,806,772,34,45,250,0.0
15976.11,809,777,32,45,251,0.0
15986.11,805,773,32,45,248,0.0
15996.11,805,773,32,45,249,0.0
16006.12,805,772,33,44,249,0.0
16016.11,803,773,30,44,249,0.0
16026.11,806,773,33,46,250,0.0
16036.13,805,773,32,46,249,0.0
16046.12,801,772,29,45,250,0.0
16056.11,804,773,31,46,249,0.0
16066.11,806,772,34,45,249,0.0
16076.11,810,778,32,44,252,0.0
16086.12,804,773,31,44,250,0.0
16096.14,803,773,30,45,251,0.0
16106.12,806,775,31,45,252,0.0
16116.11,804,772,32,44,249,0.0
16126.11,815,777,38,45,251,0.0
16136.11,804,772,32,45,249,0.0
16146.13,805,773,32,45,250,0.0
16156.11,803,772,31,45,248,0.0
16166.11,803,773,30,44,249,0.0
16176.12,805,774,31,43,250,0.0
16186.12,808,776,32,45,252,0.0
16196.11,803,770,33,43,249,0.0
16206.11,805,772,33,44,249,0.0
16216.11,806,767,39,44,247,0.0
16226.11,804,773,31,44,250,0.0
16236.13,806,773,33,43,250,0.0
16246.14,806,773,33,44,249,0.0
16256.12,802,773,29,44,249,0.0
16266.11,803,773,30,44,249,0.0
16276.11,803,772,31,43,249,0.0
16286.11,808,776,32,45,251,0.0
16296.12,805,772,33,44,250,0.0
16306.11,805,774,31,46,250,0.0
16316.13,804,771,33,45,249,0.0
16326.12,805,772,33,43,249,0.0
16336.13,804,772,32,44,250,0.0
16346.13,806,774,32,44,250,0.0
16356.1,803,772,31,44,249,0.0
16366.12,807,770,37,44,249,0.0
16376.12,804,771,33,43,249,0.0
16386.12,806,772,34,43,250,0.0
16396.11,804,767,37,43,249,-0.0333
16406.11,805,774,31,45,248,0.0
16416.11,803,772,31,45,250,0.0
16426.12,804,773,31,43,249,0.0
16436.12,805,772,33,43,250,0.0
16446.12,807,774,33,45,250,0.0
16456.12,805,773,32,45,250,0.0
16466.11,807,774,33,44,252,0.0
16476.13,806,774,32,43,249,0.0
16486.1,804,773,31,43,250,0.0
16496.11,804,773,31,44,250,0.0
16506.12,804,772,32,45,249,0.0
16516.1,809,776,33,45,251,0.0
16526.1,806,772,34,45,250,0.0
16536.14,803,772,31,45,250,0.0
16546.11,804,776,28,44,251,0.0
16556.11,803,772,31,45,249,0.0
16566.11,805,774,31,44,249,0.0
16576.11,805,773,32,45,249,0.0
16586.1,803,771,32,44,250,0.0
16596.11,804,772,32,44,249,-0.0333
16606.13,804,772,32,45,250,-0.0333
16616.12,805,770,35,43,250,0.0
16626.11,807,774,33,44,249,0.0
16636.12,803,771,32,43,248,0.0
16646.11,806,773,33,43,250,0.0
16656.11,806,774,32,45,249,0.0
16666.12,806,771,35,44,247,0.0
16676.11,804,771,33,45,249,0.0
16686.11,803,772,31,44,250,0.0
16696.11,804,772,32,43,250,0.0
16706.11,805,774,31,44,250,0.0
16716.11,804,774,30,44,249,0.0
16726.13,806,772,34,45,251,0.0
16736.1,805,772,33,44,249,0.0
16746.13,807,773,34,45,250,0.0
16756.11,805,771,34,45,249,0.0
16766.12,804,773,31,44,249,0.0
16776.13,807,773,34,44,250,0.0
16786.11,806,773,33,45,249,0.0
16796.12,803,773,30,43,249,0.0
16806.11,804,772,32,42,249,0.0
16816.11,804,773,31,44,249,0.0
16826.12,809,778,31,45,251,0.0
16836.11,804,772,32,44,249,0.0
16846.14,805,770,35,43,248,0.0
16856.11,804,771,33,45,250,0.0
16866.12,804,773,31,44,249,0.0
16876.13,805,774,31,44,250,0.0
16886.11,807,773,34,45,249,0.0
16896.12,804,772,32,45,249,0.0333
16906.12,805,772,33,45,249,0.0
16916.12,805,773,32,44,249,0.0
16926.1,809,778,31,44,251,0.0
16936.12,808,771,37,42,249,0.0
16946.12,805,775,30,44,250,0.0
16956.11,803,769,34,44,249,0.0
16966.11,805,772,33,43,248,0.0
16976.12,809,776,33,44,251,0.0
16986.12,803,772,31,45,250,0.0
16996.11,807,772,35,45,250,0.0
17006.11,805,778,27,44,247,0.0
17016.11,806,772,34,44,250,0.0
17026.12,812,774,38,44,250,0.0
17036.12,810,778,32,44,251,0.0
17046.12,805,773,32,43,250,0.0
17056.12,806,774,32,44,250,0.0
17066.13,806,772,34,44,250,0.0
17076.12,803,772,31,44,250,0.0
17086.11,804,774,30,45,249,0.0
17096.13,798,769,29,45,247,0.0
17106.1,804,772,32,44,250,0.0
17116.11,805,771,34,44,249,0.0
17126.1,804,772,32,44,250,0.0
17136.13,806,773,33,44,249,0.0
17146.11,803,772,31,44,250,-0.0333
17156.11,804,774,30,44,250,0.0
17166.11,806,774,32,45,250,0.0
17176.12,805,772,33,45,250,0.0
17186.13,801,773,28,43,250,0.0
17196.11,805,772,33,44,249,0.0
17206.11,807,773,34,43,250,0.0
17216.1,803,772,31,44,250,0.0
17226.11,807,773,34,45,250,0.0
17236.13,803,774,29,43,249,0.0
17246.12,803,771,32,45,249,0.0
17256.13,806,773,33,46,250,0.0
17266.11,804,773,31,44,249,0.0
17276.12,803,771,32,45,249,0.0
17286.11,804,771,33,44,250,0.0
17296.1,807,771,36,46,249,0.0
17306.11,809,776,33,43,251,0.0
17316.12,801,771,30,44,249,0.0
17326.13,806,772,34,45,249,0.0
17336.13,804,771,33,44,249,0.0
17346.11,803,769,34,44,249,0.0
17356.1,800,767,33,43,248,0.0
17366.11,802,771,31,44,249,0.0
17376.11,809,775,34,44,251,0.0
17386.11,800,770,30,43,249,0.0
17396.13,801,767,34,44,248,0.0
17406.11,799,767,32,45,248,0.0
17416.11,802,767,35,44,248,0.0
17426.11,801,770,31,44,247,0.0
17436.14,800,767,33,44,247,0.0
17446.1,801,770,31,45,249,0.0
17456.11,801,769,32,43,248,0.0
17466.11,799,768,31,44,248,0.0
17476.11,804,769,35,45,248,0.0
17486.12,799,770,29,44,249,0.0
17496.1,805,772,33,45,249,0.0
17506.12,796,767,29,45,247,0.0
17516.11,805,774,31,45,249,0.0
17526.13,803,773,30,44,249,0.0
17536.13,800,767,33,44,248,0.0
17546.15,805,773,32,45,251,0.0
17556.13,801,770,31,43,247,0.0
17566.11,795,769,26,44,247,0.0
17576.11,806,772,34,44,249,0.0
17586.11,805,772,33,45,250,0.0
17596.1,806,773,33,44,250,0.0
17606.11,809,776,33,43,250,0.0
17616.22,804,772,32,44,250,0.0
17626.13,805,774,31,44,250,0.0
17636.11,807,771,36,46,250,0.0
17646.12,804,772,32,44,249,0.0
17656.13,806,772,34,46,250,0.0
17666.13,805,773,32,45,249,0.0
17676.1,803,772,31,45,249,0.0
17686.11,807,771,36,43,249,0.0
17696.11,804,773,31,44,250,0.0
17706.12,809,777,32,44,251,0.0
17716.1,804,769,35,45,249,0.0
17726.11,804,772,32,46,249,0.0
17736.11,805,773,32,44,250,0.0
17746.11,803,773,30,45,249,0.0
17756.15,806,773,33,45,250,0.0
17766.15,802,773,29,44,249,0.0
17776.11,803,772,31,43,249,0.0
17786.13,804,773,31,44,249,0.0
17796.11,803,772,31,44,249,0.0
17806.1,803,772,31,43,249,0.0
17816.1,804,773,31,45,249,0.0
17826.11,803,771,32,44,250,0.0
17836.11,801,771,30,44,249,0.0
17846.12,805,772,33,44,250,0.0
17856.13,803,767,36,44,248,0.0
17866.11,805,772,33,45,250,0.0
17876.11,805,773,32,44,249,0.0
17886.11,801,768,33,44,247,0.0
17896.13,802,769,33,43,248,0.0
17906.12,804,773,31,44,250,0.0
17916.12,801,769,32,46,249,0.0
17926.11,800,768,32,43,248,0.0
17936.82,806,774,32,44,249,0.0
17946.11,799,769,30,43,248,0.0
17956.11,803,771,32,45,249,0.0
17966.12,802,769,33,44,248,0.0
17976.12,799,770,29,44,248,0.0
17986.12,804,771,33,44,249,0.0
17996.11,802,773,29,44,250,0.0
18006.12,802,773,29,45,249,0.0
18016.11,801,773,28,44,248,0.0
18026.12,801,771,30,45,248,-0.0333
18036.11,803,771,32,45,249,0.0
18046.11,802,769,33,45,249,0.0
18056.15,801,769,32,45,249,0.0
18066.11,803,772,31,44,249,0.0
18076.13,803,771,32,45,248,0.0
18086.11,803,769,34,44,248,0.0
18096.1,803,772,31,44,249,0.0
18106.36,801,770,31,45,248,0.0
18116.13,802,772,30,45,249,0.0
18126.11,802,772,30,43,249,0.0
18136.12,801,770,31,44,249,0.0
18146.12,802,770,32,44,248,0.0
18156.13,800,773,27,43,248,0.0
18166.11,801,768,33,43,249,0.0
18176.13,805,775,30,45,250,0.0
18186.13,807,774,33,43,250,0.0
18196.11,800,772,28,46,249,0.0
18206.11,804,773,31,44,249,-0.0333
18216.11,805,772,33,44,250,0.0
18226.12,804,773,31,44,249,0.0
18236.11,804,773,31,45,250,0.0
18246.13,804,773,31,45,250,0.0
18256.14,805,772,33,44,250,0.0
18266.12,805,773,32,44,249,0.0
18276.11,802,769,33,43,249,0.0
18286.12,804,770,34,44,249,-0.0333
18296.12,800,767,33,43,249,0.0
18306.1,805,773,32,45,250,0.0
18316.12,804,773,31,44,250,0.0
18326.13,806,774,32,44,250,0.0
18336.11,807,773,34,44,250,0.0
18346.11,803,769,34,46,248,0.0
18356.11,806,774,32,44,249,0.0
18366.1,806,773,33,44,250,0.0
18376.12,799,771,28,44,249,0.0
18386.11,805,773,32,46,249,0.0
18396.14,806,773,33,43,251,0.0
18406.24,804,774,30,43,250,0.0
18416.11,806,773,33,44,250,0.0
18426.11,805,773,32,45,249,0.0
18436.11,806,771,35,45,250,0.0
18446.1,803,773,30,45,249,0.0
18456.11,803,774,29,44,249,0.0
18466.14,806,771,35,45,249,0.0333
18476.12,805,774,31,45,250,0.0
18486.13,806,771,35,43,250,0.0
18496.11,803,772,31,45,249,0.0
18506.12,804,773,31,44,250,0.0
18516.12,803,773,30,45,249,0.0
18526.13,804,772,32,45,250,-0.0333
18536.11,803,771,32,44,250,0.0
18546.11,802,772,30,45,248,0.0
18556.12,806,775,31,45,250,0.0
18566.11,803,772,31,44,249,0.0
18576.25,803,772,31,44,249,0.0
18586.11,803,769,34,43,249,0.0
18596.14,804,773,31,44,249,-0.0333
18606.12,804,772,32,45,249,0.0
18616.11,802,771,31,43,249,0.0
18626.12,803,772,31,43,248,0.0
18636.14,806,774,32,43,250,0.0
18646.11,804,776,28,44,249,0.0
18656.11,803,769,34,45,249,0.0
18666.14,805,775,30,44,249,0.0
18676.11,804,774,30,45,249,0.0
18686.11,803,774,29,43,249,0.0
18696.11,804,773,31,45,249,0.0
18706.11,805,774,31,44,250,0.0
18716.11,804,771,33,44,249,0.0
18726.11,805,769,36,44,248,0.0
18736.14,806,775,31,44,250,0.0
18746.11,806,771,35,45,250,0.0
18756.11,803,771,32,44,249,0.0
18766.11,803,773,30,44,249,0.0333
18776.12,803,771,32,45,248,0.0
18786.11,805,771,34,45,249,0.0
18796.13,801,773,28,44,250,0.0
18806.13,807,773,34,46,249,0.0
18816.12,803,771,32,44,249,0.0
18826.12,806,773,33,45,249,0.0
18836.11,805,771,34,44,249,-0.0333
18846.12,805,772,33,43,249,0.0
18856.11,801,769,32,45,248,0.0
18866.14,801,769,32,44,248,0.0
18876.15,803,770,33,45,248,0.0
18886.11,803,773,30,45,249,0.0
18896.11,799,767,32,43,248,0.0
18906.11,804,774,30,44,249,0.0
18916.12,803,772,31,44,249,0.0
18926.12,803,772,31,45,248,0.0
18936.12,801,770,31,44,248,0.0
18946.12,803,770,33,44,249,0.0
18956.11,802,773,29,43,249,0.0
18966.11,803,769,34,45,249,0.0
18976.13,804,772,32,44,249,0.0
18986.11,799,771,28,44,249,0.0333
18996.13,803,772,31,45,248,0.0
19006.11,803,771,32,45,249,0.0
19016.12,803,771,32,46,250,0.0
19026.11,804,772,32,44,249,0.0
19036.11,803,771,32,45,247,0.0
19046.11,801,767,34,44,249,0.0
19056.12,806,771,35,45,250,0.0
19066.13,802,768,34,44,249,0.0
19076.11,803,774,29,45,249,0.0
19086.11,804,772,32,45,249,0.0
19096.14,801,766,35,44,247,0.0
19106.11,805,772,33,44,249,0.0
19116.12,801,772,29,44,248,0.0
19126.11,805,772,33,44,249,0.0
19136.11,801,770,31,44,249,0.0
19146.12,806,775,31,44,249,0.0
19156.12,804,771,33,44,249,0.0
19166.11,804,770,34,45,249,0.0333
19176.1,804,772,32,43,249,0.0
19186.11,815,777,38,45,251,0.0
19196.11,803,771,32,44,249,0.0
19206.12,805,773,32,45,249,0.0
19216.14,805,771,34,45,249,0.0
19226.12,804,772,32,44,250,0.0
19236.11,803,770,33,44,249,0.0
19246.12,804,772,32,44,249,0.0
19256.11,807,772,35,43,249,0.0
19266.12,804,773,31,45,249,0.0
19276.11,805,771,34,44,249,0.0
19286.21,810,775,35,45,251,0.0
19296.12,803,772,31,44,250,0.0
19306.12,806,774,32,46,250,0.0
19316.11,805,771,34,45,250,0.0
19326.11,805,771,34,44,250,0.0
19336.14,807,772,35,45,250,0.0
19346.11,808,775,33,44,247,0.0
19356.1,809,777,32,44,251,0.0
19366.12,806,768,38,44,250,0.0
19376.11,804,771,33,43,249,0.0
19386.11,806,773,33,45,249,0.0
19396.11,803,773,30,44,250,0.0
19406.14,807,773,34,44,250,0.0
19416.14,806,774,32,44,249,0.0
19426.1,803,771,32,44,250,0.0
19436.14,806,771,35,44,249,0.0
19446.11,804,772,32,44,249,0.0
19456.11,803,776,27,44,251,0.0
19466.12,803,773,30,44,249,0.0
19476.12,806,772,34,44,249,0.0
19486.13,806,776,30,44,252,0.0
19496.11,803,772,31,45,249,0.0
19506.13,806,773,33,44,250,0.0
19516.11,803,771,32,44,249,0.0
19526.1,805,772,33,43,250,0.0
19536.11,807,772,35,44,249,0.0
19546.12,803,773,30,45,249,0.0
19556.11,809,777,32,44,251,0.0
19566.12,804,772,32,44,249,0.0
19576.13,806,775,31,46,250,0.0
19586.11,801,771,30,44,249,0.0
19596.12,805,773,32,44,249,0.0
19606.12,801,772,29,44,249,0.0
19616.13,807,774,33,44,249,0.0
19626.1,804,774,30,44,249,0.0
19636.24,802,772,30,44,250,0.0
19646.11,806,776,30,45,250,0.0
19656.14,804,772,32,44,249,0.0
19666.11,804,772,32,44,249,0.0
19676.11,807,771,36,44,249,0.0
19686.12,801,773,28,44,248,-0.0333
19696.11,805,772,33,43,249,0.0
19706.12,804,771,33,44,249,0.0
19716.11,803,771,32,44,249,0.0
19726.14,806,773,33,45,249,0.0
19736.1,805,772,33,45,249,0.0
19746.11,806,771,35,45,249,0.0
19756.12,805,773,32,44,250,0.0
19766.12,807,772,35,44,250,0.0
19776.11,803,771,32,44,249,0.0
19786.11,807,774,33,44,250,0.0
19796.11,800,771,29,43,249,0.0
19806.1,804,773,31,43,250,0.0
19816.13,803,773,30,45,249,0.0
19826.12,806,771,35,45,250,0.0333
19836.12,804,773,31,44,250,0.0
19846.12,803,772,31,44,249,0.0
19856.14,801,770,31,44,249,0.0
19866.13,805,773,32,44,250,0.0
19876.12,805,774,31,44,249,0.0
19886.13,806,769,37,46,249,0.0
19896.12,803,773,30,43,250,0.0
19906.11,804,768,36,43,248,0.0
19916.11,803,771,32,44,249,0.0
19926.13,807,773,34,44,250,0.0
19936.11,805,774,31,44,249,0.0
19946.12,805,772,33,44,249,0.0
19956.11,805,774,31,45,249,0.0
19966.11,804,771,33,45,249,0.0
19976.11,804,773,31,45,249,0.0
19986.1,805,773,32,45,249,0.0
19996.13,803,771,32,45,248,0.0
20006.11,806,772,34,44,249,0.0
20016.11,807,774,33,44,250,0.0
20026.13,807,775,32,46,251,0.0
20036.12,807,774,33,44,250,0.0
20046.11,806,774,32,44,250,0.0
20056.12,804,773,31,44,250,0.0
20066.11,803,767,36,45,251,0.0
20076.14,808,773,35,45,249,0.0
20086.11,811,772,39,43,250,0.0
20096.13,806,774,32,45,251,0.0
20106.11,806,774,32,45,249,0.0
20116.1,811,778,33,44,251,0.0
20126.11,805,772,33,45,250,0.0
20136.11,803,773,30,45,250,0.0
20146.13,806,773,33,44,250,0.0
20156.12,805,773,32,44,250,0.0
20166.11,805,774,31,44,250,0.0
20176.12,803,774,29,46,249,0.0
20186.11,808,779,29,44,251,0.0
20196.1,805,773,32,45,249,0.0
20206.12,805,773,32,44,249,0.0
20216.11,806,778,28,44,251,0.0
20226.12,805,773,32,44,249,0.0
20236.11,807,775,32,45,250,0.0
20246.11,806,773,33,44,249,0.0
20256.11,803,770,33,43,249,0.0
20266.12,806,774,32,44,250,0.0
20276.11,807,775,32,45,250,-0.0333
20286.13,807,774,33,44,249,0.0
20296.12,804,773,31,45,249,0.0
20306.11,806,774,32,44,250,0.0
20316.11,806,774,32,44,250,0.0
20326.1,805,773,32,43,250,0.0
20336.13,806,773,33,44,251,0.0
20346.11,805,773,32,44,249,0.0
20356.12,811,778,33,45,252,0.0
20366.1,804,773,31,45,249,0.0
20376.14,805,772,33,44,250,0.0
20386.13,807,778,29,44,251,0.0
20396.1,804,773,31,45,250,0.0
20406.14,806,774,32,44,250,0.0
20416.12,805,774,31,46,250,0.0
20426.12,805,772,33,44,249,0.0
20436.13,807,773,34,45,250,0.0
20446.13,807,779,28,45,250,0.0
20456.12,811,778,33,45,251,0.0
20466.12,805,772,33,43,250,0.0
20476.11,807,775,32,45,250,0.0
20486.11,808,775,33,44,250,0.0
