time_ms,temp_0,temp_1,temp_0_1,diff_p,abs_p,sfm3300
-3.78,807,781,26,43,253,0.0
6.23,806,783,23,43,253,0.0
16.23,807,783,24,44,253,0.0
26.23,806,780,26,44,251,0.0
36.23,803,777,26,45,252,0.0
46.24,807,781,26,45,253,0.0
56.22,801,778,23,43,252,0.0
66.26,803,779,24,45,252,0.0
76.23,806,783,23,45,254,0.0
86.23,803,784,19,43,251,0.0
96.23,803,778,25,45,252,0.0
106.23,804,777,27,44,251,0.0
116.23,807,782,25,44,253,0.0
126.23,803,778,25,44,252,0.0
136.23,801,779,22,45,251,0.0
146.24,806,783,23,44,253,0.0
156.25,802,777,25,45,252,0.0
166.26,803,779,24,45,252,0.0
176.24,811,781,30,45,253,0.0
186.25,803,777,26,44,252,0.0
196.26,804,779,25,45,252,0.0
206.23,807,781,26,44,253,0.0
216.23,802,778,24,45,251,0.0
226.26,803,777,26,44,252,0.0
236.23,806,781,25,44,253,0.0333
246.23,802,779,23,44,252,0.0
256.23,802,779,23,44,252,0.0
266.25,800,777,23,45,253,0.0
276.23,802,779,23,45,252,0.0
286.25,805,779,26,44,252,0.0
296.27,803,780,23,46,252,0.0
306.23,808,783,25,44,254,0.0
316.23,804,779,25,45,252,0.0
326.23,802,779,23,45,252,0.0
336.25,808,784,24,44,253,0.0
346.23,804,779,25,43,252,0.0
356.23,803,779,24,44,251,0.0
366.25,808,784,24,44,253,0.0
376.24,804,778,26,44,252,0.0
386.26,804,780,24,44,252,0.0
396.23,803,778,25,45,251,0.0
406.24,803,778,25,45,252,0.0
416.22,803,778,25,46,253,0.0
426.27,804,780,24,44,251,0.0
436.22,803,778,25,45,252,0.0
446.22,807,784,23,44,252,0.0
456.24,803,778,25,44,252,0.0
466.22,808,783,25,44,253,0.0
476.25,803,778,25,44,252,0.0
486.24,802,779,23,44,253,0.0
496.23,808,784,24,45,254,0.0
506.25,802,778,24,44,252,0.0
516.23,805,779,26,45,252,0.0
526.23,801,777,24,44,251,0.0
536.22,809,778,31,46,252,0.0
546.23,804,779,25,44,253,0.0
556.25,804,779,25,45,251,0.0
566.24,803,778,25,43,252,0.0
576.23,806,778,28,44,252,0.0
586.23,802,777,25,45,252,0.0
596.22,808,784,24,45,254,0.0
606.25,802,779,23,44,252,0.0
616.26,804,780,24,44,252,-0.0333
626.23,799,780,19,45,252,0.0
636.23,804,780,24,45,252,0.0
646.25,803,779,24,44,251,0.0
656.22,803,779,24,44,252,0.0
666.23,808,781,27,45,253,0.0
676.24,802,777,25,45,252,0.0333
686.23,804,780,24,45,252,0.0
696.25,803,779,24,45,251,0.0
706.22,802,778,24,45,252,0.0
716.25,800,779,21,46,251,0.0
726.23,804,779,25,44,252,0.0
736.23,803,779,24,44,252,0.0
746.24,803,780,23,43,251,0.0
756.23,804,779,25,45,252,0.0
766.26,803,778,25,44,251,-0.0333
776.22,804,778,26,44,252,0.0
786.23,804,780,24,46,253,0.0
796.25,803,779,24,44,252,0.0
806.23,807,777,30,45,252,0.0
816.23,802,779,23,44,252,0.0
826.26,803,779,24,44,252,0.0
836.23,803,778,25,44,253,0.0
846.23,804,779,25,44,252,0.0
856.26,805,779,26,45,252,0.0
866.25,803,777,26,45,252,0.0
876.23,806,779,27,44,252,0.0
886.25,803,778,25,45,252,0.0
896.23,802,778,24,43,250,0.0
906.23,807,784,23,44,254,0.0
916.24,801,778,23,45,251,0.0
926.23,806,780,26,45,253,0.0
936.26,804,777,27,44,252,0.0
946.22,803,779,24,45,252,0.0
956.23,804,780,24,45,253,0.0
966.23,803,778,25,43,252,0.0
976.23,800,779,21,44,253,0.0
986.24,799,773,26,43,250,0.0
996.23,803,778,25,44,252,0.0
1006.26,804,777,27,44,252,0.0
1016.22,803,778,25,44,252,0.0
1026.23,806,780,26,45,252,0.0
1036.26,803,780,23,44,252,0.0
1046.23,803,780,23,44,252,0.0
1056.23,803,779,24,45,251,-0.0333
1066.26,804,778,26,44,253,0.0
1076.23,807,778,29,45,252,0.0
1086.24,805,780,25,45,252,0.0
1096.23,804,780,24,45,252,0.0
1106.27,804,779,25,46,252,0.0
1116.23,805,779,26,44,252,0.0
1126.25,804,778,26,45,252,-0.0333
1136.24,804,779,25,44,253,0.0
1146.26,809,784,25,45,254,0.0
1156.24,802,778,24,44,252,0.0
1166.23,805,783,22,44,254,0.0
1176.23,803,779,24,44,252,0.0
1186.23,803,780,23,45,252,0.0
1196.26,805,779,26,44,252,0.0
1206.23,803,779,24,45,252,0.0333
1216.23,800,774,26,44,252,0.0
1226.24,801,779,22,44,252,0.0
1236.26,803,779,24,45,252,0.0
1246.23,804,778,26,44,252,0.0
1256.23,796,778,18,43,252,0.0
1266.23,804,780,24,45,252,0.0
1276.26,804,779,25,46,252,0.0
1286.23,804,780,24,44,252,0.0
1296.23,804,778,26,45,251,0.0
1306.23,803,778,25,44,252,0.0
1316.25,809,783,26,45,253,-0.0333
1326.23,805,778,27,44,252,0.0
1336.26,805,780,25,46,252,0.0
1346.26,800,779,21,44,253,0.0
1356.23,803,778,25,43,251,0.0
1366.23,803,780,23,45,252,0.0
1376.25,803,780,23,44,252,0.0
1386.23,803,778,25,45,252,0.0
1396.24,804,779,25,43,253,0.0
1406.23,803,779,24,43,252,0.0
1416.23,803,778,25,44,252,0.0
1426.24,802,778,24,43,252,0.0
1436.23,806,775,31,45,251,0.0
1446.23,803,780,23,45,252,0.0
1456.24,803,780,23,44,253,0.0
1466.23,803,779,24,45,252,0.0
1476.24,806,779,27,44,252,0.0
1486.23,803,780,23,45,254,0.0
1496.24,802,778,24,44,252,0.0
1506.23,804,779,25,46,252,0.0
1516.23,804,778,26,43,252,0.0
1526.24,803,779,24,45,252,0.0
1536.26,804,778,26,45,252,0.0
1546.24,804,779,25,44,251,0.0
1556.26,804,778,26,44,252,0.0
1566.23,803,777,26,45,252,0.0
1576.26,805,780,25,45,252,0.0
1586.23,804,779,25,44,253,0.0
1596.24,803,778,25,44,252,0.0
1606.26,805,779,26,44,252,0.0
1616.23,803,783,20,45,251,0.0
1626.22,803,779,24,44,253,0.0
1636.24,804,778,26,44,252,0.0
1646.27,804,778,26,45,252,0.0
1656.26,801,776,25,45,252,0.0
1666.24,802,777,25,44,252,0.0
1676.23,803,779,24,44,252,0.0
1686.26,805,779,26,44,251,0.0
1696.25,803,778,25,44,252,0.0
1706.23,806,778,28,44,254,0.0
1716.24,804,779,25,44,251,0.0
1726.25,803,779,24,44,251,0.0
1736.23,804,779,25,45,252,0.0
1746.23,804,780,24,45,252,0.0
1756.27,802,776,26,45,251,0.0333
1766.24,803,778,25,44,252,0.0
1776.25,803,779,24,45,252,0.0
1786.23,803,779,24,44,252,0.0
1796.23,800,779,21,43,252,0.0
1806.24,803,779,24,44,251,0.0
1816.26,805,779,26,45,252,0.0
1826.23,804,778,26,45,252,0.0333
1836.24,803,778,25,44,252,0.0
1846.26,805,779,26,45,252,0.0
1856.27,804,779,25,44,252,0.0
1866.23,804,778,26,45,252,0.0
1876.23,805,779,26,45,251,0.0
1886.22,809,778,31,44,254,0.0
1896.26,803,779,24,44,251,0.0
1906.22,803,778,25,44,252,0.0
1916.26,804,780,24,45,252,0.0
1926.23,803,779,24,44,252,0.0
1936.24,803,779,24,45,252,0.0
1946.23,804,779,25,44,252,0.0
1956.24,804,779,25,43,251,0.0
1966.24,804,779,25,44,252,0.0
1976.23,804,771,33,45,253,0.0
1986.27,804,779,25,44,252,-0.0333
1996.26,804,778,26,44,253,0.0
2006.23,804,778,26,45,252,0.0
2016.23,804,780,24,45,252,0.0
2026.27,804,779,25,45,253,0.0333
2036.24,806,779,27,44,252,0.0
2046.23,804,778,26,45,251,0.0
2056.23,804,778,26,44,252,-0.0333
2066.26,799,780,19,45,251,0.0
2076.24,800,779,21,44,253,0.0
2086.26,804,780,24,45,252,0.0
2096.23,803,779,24,45,251,0.0
2106.23,803,779,24,45,252,0.0
2116.26,805,779,26,45,252,0.0
2126.23,804,778,26,43,251,0.0
2136.22,804,778,26,44,252,0.0
2146.23,803,777,26,46,251,0.0
2156.27,803,778,25,44,253,0.0
2166.26,804,777,27,45,251,0.0
2176.22,801,779,22,44,252,0.0
2186.26,804,779,25,45,252,0.0
2196.23,805,779,26,45,252,0.0
2206.22,804,779,25,44,252,0.0
2216.23,804,778,26,45,252,-0.0333
2226.22,804,779,25,44,253,0.0
2236.26,803,779,24,44,252,0.0
2246.24,803,774,29,44,253,0.0
2256.23,804,781,23,45,252,0.0
2266.27,804,777,27,45,253,0.0
2276.24,803,779,24,43,252,-0.0333
2286.23,804,779,25,46,253,0.0
2296.22,801,775,26,45,251,0.0
2306.25,803,779,24,45,252,0.0
2316.23,804,779,25,44,252,0.0
2326.22,804,779,25,44,252,0.0
2336.27,797,778,19,45,251,0.0
2346.23,803,779,24,43,252,0.0
2356.24,804,779,25,45,252,0.0
2366.23,802,780,22,44,252,0.0
2376.24,803,779,24,45,252,0.0
2386.22,804,778,26,44,251,0.0
2396.25,803,779,24,43,252,0.0
2406.23,801,778,23,44,251,0.0
2416.22,805,780,25,44,252,0.0
2426.27,813,781,32,45,252,0.0
2436.23,806,780,26,43,252,0.0
2446.23,804,778,26,45,252,0.0
2456.22,804,780,24,46,253,0.0
2466.25,801,775,26,45,251,0.0
2476.24,803,778,25,45,252,0.0
2486.23,806,779,27,44,252,0.0
2496.23,804,780,24,44,253,-0.0333
2506.25,803,778,25,45,252,0.0
2516.24,806,779,27,44,252,0.0
2526.26,806,781,25,45,252,0.0
2536.27,805,780,25,44,252,0.0
2546.23,805,780,25,44,252,0.0
2556.25,805,780,25,44,252,0.0
2566.24,804,780,24,44,252,-0.0333
2576.25,804,779,25,44,252,0.0
2586.25,806,780,26,44,252,0.0
2596.23,807,781,26,44,252,0.0
2606.23,799,786,13,44,250,0.0
2616.24,804,779,25,45,253,0.0
2626.25,805,780,25,45,252,0.0
2636.25,803,776,27,44,251,0.0
2646.23,803,779,24,45,252,0.0
2656.25,804,779,25,43,253,0.0
2666.24,800,780,20,44,252,0.0
2676.25,804,779,25,45,252,0.0
2686.24,805,780,25,44,252,0.0
2696.25,806,776,30,45,254,0.0
2706.26,804,781,23,44,252,0.0
2716.22,804,779,25,44,252,-0.0333
2726.26,805,779,26,44,253,-0.0333
2736.23,805,779,26,45,252,0.0
2746.23,804,779,25,45,252,0.0
2756.25,805,780,25,44,252,0.0
2766.23,804,780,24,45,253,0.0
2776.27,807,780,27,44,252,0.0
2786.23,798,779,19,44,252,0.0
2796.26,805,781,24,45,253,0.0
2806.25,806,780,26,45,251,0.0
2816.24,805,778,27,44,252,0.0
2826.24,805,778,27,44,253,0.0
2836.27,805,779,26,44,252,0.0
2846.23,804,779,25,45,252,0.0
2856.24,804,779,25,44,252,-0.0333
2866.25,806,781,25,45,252,0.0
2876.27,799,780,19,45,252,0.0
2886.23,805,780,25,44,253,0.0
2896.23,804,779,25,46,252,0.0
2906.24,803,778,25,45,252,0.0
2916.23,805,779,26,43,252,0.0
2926.24,804,779,25,43,252,0.0
2936.27,806,781,25,45,252,0.0
2946.27,805,780,25,45,251,0.0
2956.23,803,780,23,44,252,0.0
2966.23,808,775,33,46,253,0.0
2976.24,801,779,22,44,252,0.0
2986.24,804,779,25,44,253,0.0
2996.23,804,779,25,44,252,-0.0333
3006.23,805,779,26,43,252,0.0
3016.27,804,779,25,46,252,0.0
3026.24,804,779,25,44,252,0.0
3036.23,806,780,26,45,252,0.0
3046.23,805,780,25,44,253,0.0
3056.24,804,779,25,43,252,0.0
3066.25,806,779,27,45,252,0.0
3076.24,804,780,24,44,252,0.0
3086.23,804,780,24,45,252,0.0
3096.24,805,780,25,44,252,0.0
3106.26,806,780,26,43,252,0.0
3116.23,803,779,24,46,251,0.0
3126.25,803,779,24,45,252,0.0
3136.25,805,781,24,43,252,0.0
3146.23,800,778,22,44,252,0.0
3156.23,804,778,26,44,252,0.0
3166.23,804,779,25,44,252,0.0
3176.23,805,780,25,44,252,0.0
3186.23,805,778,27,44,252,0.0
3196.25,804,779,25,44,252,0.0
3206.25,805,780,25,45,252,0.0
3216.23,803,781,22,44,252,0.0
3226.23,805,779,26,45,252,0.0
3236.23,799,774,25,45,253,0.0
3246.22,804,779,25,45,252,0.0
3256.24,803,779,24,44,252,0.0
3266.25,807,778,29,43,251,0.0
3276.23,805,780,25,45,252,0.0
3286.23,804,778,26,44,252,0.0333
3296.25,804,779,25,44,253,0.0
3306.23,806,780,26,44,253,0.0
3316.25,803,777,26,43,252,0.0
3326.23,800,779,21,43,253,0.0
3336.25,805,780,25,45,251,0.0
3346.27,804,780,24,44,252,0.0
3356.23,804,778,26,44,252,0.0
3366.25,806,779,27,45,253,0.0
3376.26,806,781,25,46,252,-0.0333
3386.26,804,780,24,44,252,0.0
3396.24,805,778,27,45,252,0.0
3406.26,804,780,24,44,253,0.0
3416.23,797,779,18,45,250,0.0
3426.24,803,779,24,44,252,0.0
3436.24,805,781,24,44,252,0.0
3446.23,806,779,27,45,253,0.0
3456.23,804,779,25,43,252,0.0
3466.24,806,779,27,44,252,0.0
3476.25,805,780,25,43,253,-0.0333
3486.23,802,776,26,44,250,0.0
3496.24,804,780,24,45,253,0.0
3506.24,799,779,20,44,252,0.0
3516.27,806,779,27,43,252,0.0
3526.23,804,779,25,43,253,0.0
3536.23,804,780,24,44,252,0.0
3546.26,805,780,25,44,253,0.0
3556.27,805,780,25,46,252,0.0
3566.25,805,779,26,45,253,0.0
3576.23,804,779,25,44,253,0.0
3586.23,804,779,25,44,252,0.0
3596.27,803,775,28,45,251,0.0
3606.23,805,780,25,44,252,-0.0333
3616.23,805,780,25,44,252,-0.0333
3626.27,805,779,26,45,253,0.0
3636.23,803,780,23,45,252,0.0
3646.25,805,779,26,45,253,0.0
3656.23,800,776,24,42,252,0.0
3666.24,801,777,24,45,252,0.0
3676.25,805,779,26,44,252,-0.0333
3686.23,807,780,27,45,254,0.0
3696.26,805,779,26,43,252,0.0
3706.25,803,779,24,44,253,0.0
3716.23,804,780,24,44,252,0.0
3726.26,803,780,23,45,252,0.0
3736.23,804,780,24,45,253,0.0
3746.25,805,780,25,45,252,0.0
3756.24,804,779,25,44,252,0.0
3766.26,805,778,27,44,252,0.0
3776.25,805,781,24,45,252,0.0
3786.24,806,780,26,44,252,0.0
3796.23,805,779,26,45,252,0.0
3806.23,804,779,25,44,252,0.0
3816.26,807,779,28,44,253,0.0
3826.25,802,776,26,45,252,0.0
3836.24,804,778,26,44,253,0.0
3846.23,804,779,25,44,252,0.0
3856.23,804,780,24,44,252,0.0
3866.23,808,777,31,45,253,0.0
3876.23,802,778,24,43,252,0.0
3886.25,804,779,25,44,251,0.0
3896.27,804,779,25,46,252,0.0
3906.23,802,776,26,45,252,0.0
3916.26,804,778,26,44,253,0.0
3926.23,805,778,27,45,252,0.0
3936.26,803,779,24,45,252,0.0
3946.23,805,779,26,43,252,0.0
3956.27,800,777,23,44,251,-0.0333
3966.23,804,778,26,45,252,0.0
3976.24,804,779,25,44,252,0.0
3986.23,804,780,24,44,252,0.0
3996.25,805,776,29,43,251,0.0
4006.23,803,778,25,44,252,0.0
4016.25,803,778,25,44,252,0.0
4026.26,805,779,26,43,253,0.0
4036.26,803,777,26,45,251,0.0
4046.24,805,783,22,45,252,0.0
4056.23,805,779,26,45,252,0.0
4066.23,804,779,25,45,252,0.0
4076.23,803,778,25,44,252,0.0
4086.23,804,779,25,43,252,0.0
4096.25,805,779,26,45,252,0.0
4106.23,802,778,24,44,253,0.0
4116.24,804,779,25,45,252,0.0
4126.24,803,778,25,45,252,0.0
4136.23,803,771,32,44,251,0.0
4146.23,804,779,25,44,251,0.0
4156.25,804,779,25,46,252,0.0
4166.23,800,777,23,43,251,0.0
4176.23,803,778,25,44,252,0.0
4186.23,804,778,26,45,252,0.0
4196.23,803,779,24,43,252,0.0
4206.23,804,776,28,44,252,0.0
4216.24,803,779,24,44,251,0.0
4226.23,806,775,31,45,253,0.0
4236.26,806,779,27,45,252,0.0
4246.23,803,778,25,45,252,0.0
4256.23,804,779,25,46,252,0.0
4266.25,805,778,27,43,252,0.0
4276.26,803,778,25,43,252,0.0
4286.24,803,779,24,44,252,0.0
4296.23,805,778,27,45,251,0.0
4306.25,804,779,25,45,252,0.0
4316.24,807,779,28,45,252,0.0
4326.23,804,779,25,44,252,0.0
4336.24,800,775,25,45,251,0.0
4346.23,803,779,24,44,252,0.0
4356.23,805,778,27,43,252,0.0
4366.26,801,779,22,44,252,0.0
4376.26,804,777,27,44,252,0.0
4386.24,804,779,25,44,252,-0.0333
4396.23,803,778,25,45,252,0.0
4406.23,796,773,23,44,252,0.0
4416.23,805,779,26,44,252,0.0
4426.23,803,778,25,45,252,0.0
4436.25,803,779,24,44,252,0.0
4446.26,803,778,25,44,252,0.0
4456.24,803,779,24,46,253,0.0
4466.27,805,779,26,43,252,0.0
4476.26,804,778,26,44,252,0.0
4486.24,803,779,24,44,252,0.0333
4496.23,804,778,26,46,252,0.0
4506.24,801,775,26,44,252,0.0
4516.23,805,779,26,44,252,0.0
4526.25,804,778,26,45,252,0.0
4536.27,804,779,25,45,251,0.0
4546.23,803,778,25,45,251,0.0
4556.23,802,778,24,44,252,0.0
4566.26,805,779,26,44,253,0.0
4576.23,804,779,25,45,252,0.0
4586.24,804,779,25,44,253,0.0
4596.25,803,778,25,45,252,0.0
4606.24,803,778,25,45,251,0.0
4616.23,803,779,24,44,252,0.0
4626.23,805,780,25,44,252,0.0
4636.27,804,780,24,45,252,0.0
4646.26,803,778,25,46,251,0.0
4656.23,803,776,27,44,252,0.0
4666.23,806,779,27,44,252,-0.0333
4676.25,800,773,27,45,251,0.0
4686.23,803,778,25,44,252,0.0
4696.25,804,779,25,45,252,0.0
4706.26,804,779,25,44,252,0.0
4716.23,804,778,26,45,252,0.0
4726.24,803,778,25,44,252,0.0
4736.25,806,780,26,45,253,0.0
4746.23,804,779,25,45,252,0.0
4756.23,804,779,25,44,251,0.0
4766.23,804,777,27,45,252,0.0
4776.23,805,778,27,44,252,0.0
4786.26,803,779,24,43,253,0.0
4796.24,804,779,25,45,252,0.0
4806.27,806,778,28,44,252,0.0
4816.23,804,779,25,45,252,0.0
4826.23,804,778,26,44,252,0.0
4836.23,806,780,26,45,252,0.0
4846.23,800,775,25,42,252,0.0
4856.24,802,784,18,44,252,0.0
4866.25,804,779,25,44,252,0.0
4876.26,804,779,25,44,252,0.0
4886.23,803,776,27,44,251,0.0
4896.23,804,778,26,43,252,0.0
4906.23,804,780,24,45,252,0.0
4916.26,802,779,23,44,251,0.0
4926.24,803,778,25,44,252,0.0
4936.26,804,778,26,44,252,0.0
4946.22,803,778,25,45,252,0.0
4956.23,803,778,25,44,252,0.0
4966.24,806,780,26,44,252,0.0
4976.23,805,778,27,44,252,0.0
4986.27,804,778,26,44,252,0.0
4996.24,804,779,25,43,252,0.0
5006.25,803,780,23,44,252,0.0
5016.25,799,774,25,43,251,0.0
5026.23,804,778,26,44,252,0.0
5036.23,807,783,24,44,254,0.0
5046.23,804,779,25,44,252,0.0
5056.26,800,777,23,44,251,0.0
5066.24,802,778,24,44,252,0.0
5076.23,804,780,24,44,252,0.0
5086.27,804,779,25,45,252,0.0
5096.23,804,778,26,44,252,0.0
5106.23,804,779,25,44,252,0.0
5116.25,803,779,24,44,252,0.0
5126.23,803,785,18,44,252,0.0
5136.24,804,779,25,45,252,0.0
5146.24,805,779,26,44,252,0.0
5156.23,804,778,26,45,251,0.0
5166.23,802,778,24,45,252,0.0
5176.25,804,778,26,44,253,0.0
5186.23,800,776,24,44,251,0.0
5196.23,804,778,26,44,252,0.0
5206.25,805,778,27,44,252,0.0
5216.23,805,783,22,46,251,0.0
5226.23,804,778,26,43,252,0.0333
5236.23,803,779,24,45,252,0.0
5246.23,805,780,25,44,252,0.0
5256.23,803,780,23,45,252,0.0
5266.23,803,779,24,44,252,0.0
5276.23,804,778,26,44,252,0.0
5286.23,802,779,23,44,252,0.0
5296.26,803,778,25,44,252,0.0
5306.23,804,780,24,44,251,-0.0333
5316.27,804,778,26,44,252,0.0
5326.26,804,778,26,45,252,0.0
5336.23,803,778,25,45,252,0.0
5346.25,804,779,25,45,253,0.0
5356.23,802,775,27,45,251,0.0
5366.23,804,778,26,43,252,-0.0333
5376.23,804,779,25,43,252,0.0
5386.23,804,779,25,44,252,0.0
5396.25,796,783,13,44,250,0.0
5406.24,803,776,27,44,251,-0.0333
5416.23,805,780,25,46,252,0.0
5426.26,806,780,26,45,252,0.0
5436.24,804,779,25,44,253,0.0
5446.25,804,778,26,44,252,0.0
5456.24,805,779,26,45,252,0.0
5466.26,804,778,26,43,252,0.0
5476.24,805,779,26,44,252,0.0
5486.23,804,774,30,45,250,0.0
5496.23,804,779,25,46,251,0.0
5506.24,803,779,24,45,252,0.0
5516.23,805,779,26,45,252,0.0
5526.23,802,776,26,46,251,0.0
5536.24,803,779,24,45,252,0.0
5546.23,803,778,25,43,251,0.0
5556.27,804,777,27,44,252,-0.0333
5566.23,804,778,26,45,252,0.0
5576.23,803,779,24,45,252,0.0
5586.25,804,778,26,45,252,0.0
5596.23,804,779,25,45,252,0.0
5606.24,804,779,25,44,253,0.0
5616.23,803,778,25,44,252,0.0
5626.23,803,778,25,44,251,0.0333
5636.25,804,779,25,45,252,0.0
5646.23,805,778,27,44,252,0.0
5656.24,804,779,25,45,251,0.0
5666.23,803,773,30,43,251,0.0
5676.23,803,779,24,44,252,0.0
5686.23,804,780,24,45,253,0.0
5696.25,803,780,23,45,251,0.0
5706.25,803,778,25,44,251,0.0
5716.24,805,778,27,44,252,0.0
5726.23,804,779,25,44,252,0.0
5736.25,803,776,27,44,251,0.0
5746.24,803,779,24,44,252,0.0
5756.23,799,781,18,44,250,0.0
5766.23,803,779,24,43,252,0.0
5776.22,804,779,25,44,252,0.0
5786.25,805,779,26,44,251,0.0333
5796.24,803,778,25,45,251,0.0
5806.26,805,779,26,44,252,0.0
5816.24,804,779,25,44,252,0.0
5826.28,805,780,25,46,252,0.0
5836.23,804,779,25,45,252,0.0
5846.25,804,783,21,45,252,0.0
5856.26,804,779,25,44,252,0.0
5866.23,805,776,29,45,252,0.0
5876.23,803,779,24,44,252,0.0
5886.23,804,777,27,44,251,0.0
5896.27,801,778,23,45,252,0.0
5906.23,805,780,25,44,252,0.0
5916.24,803,778,25,45,252,0.0
5926.23,804,780,24,44,253,0.0
5936.23,804,780,24,46,250,-0.0333
5946.23,803,778,25,44,251,0.0
5956.26,804,779,25,46,252,0.0
5966.25,803,778,25,43,252,0.0
5976.23,802,778,24,43,252,0.0
5986.24,805,780,25,45,252,0.0
5996.26,807,779,28,44,252,0.0
6006.23,803,778,25,44,252,0.0
6016.24,806,779,27,45,252,0.0
6026.23,808,781,27,45,254,0.0
6036.25,803,777,26,45,251,0.0
6046.24,804,780,24,44,253,0.0
6056.24,804,779,25,45,252,0.0333
6066.28,804,780,24,45,252,0.0
6076.26,804,778,26,44,253,0.0
6086.23,804,780,24,44,252,0.0
6096.26,806,780,26,45,253,0.0
6106.26,804,780,24,45,252,0.0
6116.24,805,779,26,44,254,0.0
6126.23,805,779,26,44,253,0.0
6136.23,804,779,25,43,252,0.0
6146.26,804,776,28,44,252,0.0
6156.24,804,778,26,44,253,0.0
6166.24,805,779,26,46,251,0.0
6176.23,805,779,26,44,252,0.0
6186.23,805,780,25,44,252,0.0
6196.22,805,781,24,45,253,0.0
6206.24,801,772,29,44,253,0.0
6216.24,804,780,24,44,253,0.0
6226.24,804,780,24,44,252,0.0
6236.27,803,779,24,44,252,0.0
6246.23,805,778,27,46,252,0.0
6256.25,805,779,26,43,253,0.0
6266.23,805,779,26,45,252,0.0
6276.27,805,780,25,45,252,0.0
6286.25,805,780,25,44,253,0.0
6296.25,806,773,33,43,253,0.0
6306.24,806,779,27,44,252,-0.0333
6316.23,806,779,27,44,252,0.0
6326.23,807,780,27,44,252,0.0
6336.26,805,779,26,45,252,0.0
6346.26,804,779,25,44,252,0.0
6356.23,803,779,24,44,253,0.0
6366.23,806,780,26,46,253,0.0
6376.24,805,780,25,44,251,0.0
6386.25,806,780,26,45,253,-0.0333
6396.23,805,777,28,44,252,0.0
6406.23,803,780,23,44,252,0.0
6416.23,805,780,25,44,253,0.0
6426.22,803,779,24,44,252,0.0
6436.23,805,780,25,46,252,0.0
6446.23,804,781,23,43,252,0.0333
6456.25,803,779,24,45,252,0.0
6466.25,805,779,26,44,253,0.0
6476.24,806,779,27,44,252,0.0
6486.25,804,780,24,44,253,0.0
6496.23,805,780,25,44,253,0.0
6506.24,805,780,25,45,253,0.0
6516.26,804,779,25,44,253,0.0
6526.25,806,780,26,44,252,0.0
6536.26,806,781,25,44,253,0.0
6546.25,801,777,24,45,251,0.0
6556.23,803,779,24,44,252,0.0
6566.24,807,775,32,45,252,0.0
6576.23,804,779,25,44,252,0.0
6586.23,804,778,26,45,252,-0.0333
6596.24,804,779,25,44,252,0.0
6606.25,807,781,26,45,253,0.0
6616.23,805,779,26,44,252,0.0
6626.23,804,779,25,44,252,0.0
6636.25,805,777,28,44,252,0.0
6646.25,803,777,26,45,252,-0.0333
6656.26,803,774,29,44,250,0.0
6666.23,805,780,25,44,252,0.0
6676.26,805,779,26,45,252,0.0
6686.23,804,778,26,44,251,0.0
6696.23,804,780,24,44,252,0.0
6706.26,807,780,27,44,253,0.0
6716.23,803,776,27,45,251,0.0
6726.23,804,780,24,45,252,-0.0333
6736.24,804,779,25,44,252,0.0
6746.24,800,777,23,43,251,0.0
6756.23,805,781,24,45,252,0.0
6766.24,803,779,24,44,252,0.0
6776.26,805,780,25,44,252,0.0
6786.23,804,779,25,45,252,0.0
6796.24,804,778,26,44,252,0.0
6806.25,806,781,25,45,253,0.0
6816.24,804,779,25,44,252,0.0
6826.23,804,779,25,45,252,0.0
6836.23,804,783,21,44,252,0.0
6846.23,805,779,26,43,252,0.0
6856.23,802,779,23,44,252,-0.0333
6866.24,804,779,25,43,253,0.0
6876.23,806,780,26,45,252,0.0
6886.23,802,776,26,45,251,0.0
6896.23,804,779,25,44,251,0.0
6906.23,805,779,26,44,252,0.0
6916.26,805,780,25,45,252,0.0
6926.23,811,780,31,45,253,0.0
6936.23,804,779,25,43,252,0.0
6946.23,806,780,26,44,253,0.0
6956.26,804,780,24,45,252,0.0
6966.24,805,780,25,45,253,0.0
6976.23,805,779,26,44,252,0.0
6986.25,804,780,24,44,253,0.0
6996.23,803,778,25,43,252,0.0
7006.24,804,780,24,44,252,0.0
7016.26,801,781,20,45,254,0.0
7026.23,805,779,26,44,252,0.0
7036.23,804,780,24,45,253,0.0
7046.25,806,780,26,46,252,0.0
7056.24,799,777,22,45,252,0.0
7066.23,804,779,25,44,252,0.0
7076.23,805,779,26,45,252,0.0
7086.27,804,780,24,45,253,0.0
7096.23,805,779,26,44,252,0.0
7106.23,803,776,27,44,254,0.0
7116.25,804,780,24,45,253,0.0
7126.23,805,780,25,45,252,0.0
7136.24,804,779,25,45,252,0.0
7146.26,804,779,25,46,252,0.0
7156.23,803,778,25,44,252,0.0
7166.23,804,778,26,44,252,0.0
7176.24,805,781,24,44,253,0.0
7186.26,805,779,26,44,252,0.0
7196.23,799,785,14,45,250,-0.0333
7206.23,804,780,24,44,252,0.0
7216.23,805,780,25,45,253,0.0
7226.23,806,777,29,44,252,0.0
7236.23,804,780,24,44,252,0.0
7246.24,806,779,27,44,253,0.0
7256.23,803,780,23,45,252,-0.0333
7266.26,804,778,26,45,253,0.0
7276.23,805,779,26,43,252,0.0
7286.26,805,783,22,44,253,0.0
7296.27,806,780,26,43,253,0.0
7306.24,802,778,24,45,252,0.0
7316.23,804,780,24,44,252,0.0
7326.23,804,780,24,44,253,0.0
7336.23,803,779,24,45,252,0.0
7346.24,805,776,29,43,251,0.0
7356.26,804,780,24,44,252,0.0
7366.25,804,779,25,45,252,0.0
7376.24,803,786,17,43,252,0.0
7386.23,805,780,25,44,252,0.0
7396.23,801,778,23,45,252,0.0
7406.24,805,779,26,44,252,0.0
7416.23,805,779,26,44,251,0.0
7426.23,803,779,24,43,252,0.0
7436.26,804,780,24,44,252,0.0
7446.24,803,779,24,43,252,0.0
7456.25,806,781,25,45,253,0.0
7466.23,801,777,24,44,252,0.0
7476.23,805,779,26,44,252,0.0
7486.25,805,779,26,44,253,0.0
7496.24,805,779,26,45,252,0.0
7506.23,799,774,25,44,251,0.0
7516.24,803,779,24,44,252,0.0
7526.23,805,781,24,44,252,0.0
7536.27,804,780,24,45,252,0.0
7546.24,805,779,26,44,252,0.0
7556.23,799,775,24,44,254,0.0
7566.23,805,779,26,44,252,0.0
7576.24,804,781,23,44,252,0.0
7586.23,805,779,26,44,252,0.0
7596.26,806,779,27,45,252,0.0
7606.25,804,779,25,45,252,0.0
7616.24,804,779,25,45,252,0.0
7626.23,806,780,26,45,253,0.0
7636.24,805,780,25,45,251,0.0
7646.24,807,779,28,44,252,0.0
7656.24,804,776,28,46,252,0.0
7666.27,805,779,26,44,252,0.0
7676.26,805,778,27,45,252,0.0
7686.24,804,779,25,44,253,0.0
7696.26,805,781,24,45,252,0.0
7706.27,805,780,25,45,252,0.0
7716.22,804,779,25,45,252,0.0
7726.23,803,778,25,44,252,0.0
7736.25,805,779,26,44,253,0.0
7746.27,805,779,26,44,252,0.0
7756.24,804,780,24,43,253,0.0
7766.23,806,780,26,45,253,0.0
7776.27,804,780,24,44,252,0.0
7786.24,805,780,25,43,252,0.0
7796.25,805,780,25,44,253,0.0
7806.23,802,779,23,45,252,0.0
7816.24,804,780,24,45,252,0.0
7826.23,799,783,16,44,252,0.0
7836.24,805,779,26,45,252,0.0
7846.23,806,779,27,44,252,0.0
7856.25,804,780,24,43,252,0.0
7866.23,805,781,24,44,253,0.0
7876.23,805,780,25,45,253,0.0
7886.25,803,780,23,44,253,0.0
7896.26,805,778,27,42,252,0.0
7906.23,805,779,26,44,252,0.0
7916.23,805,781,24,44,255,0.0
7926.24,804,780,24,44,252,-0.0333
7936.25,806,781,25,45,253,0.0
7946.23,804,780,24,44,252,0.0
7956.24,805,779,26,45,252,0.0
7966.25,804,779,25,45,252,0.0
7976.25,803,779,24,45,252,0.0
7986.23,803,780,23,45,252,0.0
7996.24,806,780,26,45,253,0.0
8006.23,806,780,26,45,253,0.0
8016.23,806,780,26,44,252,0.0
8026.24,804,779,25,44,252,0.0
8036.25,805,780,25,44,253,0.0
8046.23,804,776,28,45,251,0.0
8056.25,804,779,25,43,253,0.0
8066.22,804,779,25,45,252,0.0
8076.28,804,779,25,44,252,-0.0333
8086.23,801,779,22,45,252,0.0
8096.24,804,776,28,44,254,0.0
8106.23,806,780,26,45,252,0.0
8116.23,804,780,24,45,252,0.0
8126.23,806,780,26,44,253,0.0
8136.26,805,779,26,45,252,0.0
8146.24,804,780,24,43,252,0.0
8156.23,803,778,25,43,253,0.0
8166.23,804,780,24,44,253,0.0
8176.27,806,781,25,45,252,0.0
8186.23,799,780,19,45,252,0.0
8196.22,804,780,24,43,252,0.0
8206.23,806,780,26,44,252,0.0
8216.25,802,776,26,44,251,0.0
8226.25,805,779,26,44,252,0.0
8236.24,805,779,26,45,252,0.0
8246.27,803,780,23,43,253,0.0
8256.23,805,778,27,45,252,0.0
8266.24,804,780,24,43,253,0.0
8276.26,808,782,26,45,253,0.0
8286.23,805,780,25,45,252,0.0
8296.23,804,779,25,44,252,0.0
8306.23,805,780,25,45,251,0.0
8316.24,805,779,26,45,252,-0.0333
8326.25,805,778,27,44,252,0.0
8336.23,806,780,26,44,253,0.0
8346.27,804,781,23,44,252,0.0
8356.23,805,780,25,44,252,0.0
8366.25,804,773,31,43,254,0.0
8376.23,806,778,28,45,252,0.0
8386.23,805,780,25,43,251,0.0
8396.22,804,779,25,43,253,0.0
8406.23,803,778,25,46,252,0.0
8416.23,804,779,25,43,252,0.0
8426.23,805,779,26,44,253,0.0
8436.25,804,779,25,45,252,0.0
8446.23,804,781,23,44,253,0.0
8456.23,799,775,24,44,252,0.0
8466.23,806,780,26,45,252,0.0
8476.26,805,779,26,45,252,0.0
8486.24,804,779,25,45,252,0.0
8496.27,807,779,28,45,252,0.0
8506.24,804,779,25,45,253,0.0
8516.23,806,781,25,44,252,0.0
8526.23,805,779,26,44,252,0.0
8536.24,804,780,24,43,253,0.0
8546.23,800,783,17,45,252,0.0
8556.23,804,779,25,45,253,0.0
8566.25,804,781,23,44,252,0.0
8576.24,804,779,25,46,252,0.0
8586.23,804,779,25,44,253,0.0
8596.24,806,778,28,46,252,0.0
8606.24,803,779,24,45,252,0.0
8616.23,806,775,31,44,254,0.0
8626.23,805,780,25,45,252,0.0
8636.24,803,784,19,45,255,0.0
8646.25,804,778,26,45,252,0.0
8656.23,803,777,26,45,252,0.0
8666.23,804,778,26,44,253,0.0
8676.23,804,779,25,44,252,0.0
8686.25,806,781,25,45,253,-0.0333
8696.23,804,780,24,44,253,0.0
8706.24,804,780,24,43,252,0.0
8716.25,805,779,26,45,252,0.0
8726.25,805,776,29,43,252,0.0
8736.26,804,779,25,44,252,0.0
8746.25,806,779,27,44,251,0.0
8756.24,806,781,25,44,253,0.0
8766.23,804,779,25,45,252,0.0
8776.23,804,779,25,43,252,0.0
8786.23,805,780,25,45,252,0.0
8796.25,801,776,25,45,251,0.0
8806.25,805,779,26,45,252,-0.0333
8816.22,807,783,24,45,253,0.0
8826.28,804,779,25,44,252,0.0
8836.26,804,778,26,44,252,0.0
8846.23,804,779,25,44,252,0.0
8856.23,806,778,28,45,252,0.0
8866.23,806,780,26,45,253,0.0
8876.23,804,779,25,45,252,0.0
8886.23,805,779,26,44,252,0.0
8896.25,803,780,23,44,252,0.0
8906.23,804,776,28,44,254,0.0
8916.24,804,779,25,44,252,0.0
8926.23,806,781,25,45,253,0.0
8936.26,804,778,26,44,252,0.0
8946.22,804,779,25,43,253,0.0
8956.25,806,780,26,46,252,0.0
8966.24,805,779,26,45,252,0.0
8976.23,805,779,26,44,251,0.0
8986.22,805,779,26,43,251,0.0
8996.23,799,781,18,44,253,0.0
9006.23,805,779,26,44,252,0.0
9016.24,805,779,26,45,252,0.0
9026.23,805,780,25,45,253,0.0
9036.23,806,780,26,44,252,0.0
9046.24,805,779,26,44,252,0.0
9056.25,805,779,26,44,252,0.0
9066.25,804,779,25,44,252,0.0
9076.23,803,779,24,44,252,0.0
9086.23,804,784,20,45,253,0.0
9096.23,807,781,26,46,252,0.0
9106.23,804,780,24,43,253,0.0
9116.24,804,779,25,44,252,0.0
9126.23,805,779,26,46,253,0.0
9136.24,804,779,25,43,252,0.0
9146.23,804,780,24,44,253,0.0
9156.23,804,778,26,45,251,0.0
9166.24,806,779,27,44,252,0.0
9176.23,807,779,28,45,253,0.0
9186.23,803,780,23,44,252,0.0
9196.25,804,781,23,44,253,0.0
9206.23,804,780,24,46,252,0.0
9216.25,803,780,23,43,252,0.0
9226.23,805,780,25,44,252,0.0
9236.24,805,779,26,45,253,0.0
9246.27,805,780,25,44,253,0.0
9256.23,804,779,25,43,252,0.0
9266.25,807,775,32,44,253,0.0
9276.23,805,780,25,44,253,0.0
9286.23,805,780,25,44,253,0.0
9296.23,803,780,23,45,252,0.0
9306.25,804,780,24,43,252,0.0
9316.23,804,779,25,44,252,0.0
9326.22,805,780,25,43,252,0.0
9336.26,805,780,25,43,252,0.0
9346.26,806,779,27,44,252,0.0
9356.25,804,776,28,44,254,-0.0333
9366.23,805,780,25,44,252,0.0
9376.24,801,777,24,44,252,0.0
9386.23,804,779,25,44,252,0.0
9396.24,806,780,26,44,252,0.0
9406.27,804,778,26,44,252,0.0
9416.23,804,778,26,43,252,0.0
9426.23,803,778,25,44,252,0.0
9436.23,805,781,24,45,252,0.0
9446.25,809,782,27,44,253,0.0
9456.24,805,779,26,44,253,0.0
9466.23,805,779,26,45,252,0.0
9476.24,805,779,26,45,253,0.0333
9486.23,803,780,23,43,252,0.0
9496.24,802,780,22,44,253,0.0
9506.26,806,780,26,43,253,-0.0333
9516.23,804,778,26,44,253,0.0
9526.24,804,780,24,44,252,0.0
9536.23,799,780,19,45,254,0.0
9546.25,804,781,23,44,251,0.0
9556.23,804,780,24,43,252,-0.0333
9566.24,805,778,27,44,253,0.0
9576.23,805,779,26,43,252,0.0
9586.23,803,778,25,44,252,0.0
9596.23,804,779,25,45,252,0.0
9606.25,804,779,25,45,252,0.0333
9616.23,805,780,25,45,252,0.0
9626.24,807,780,27,44,253,0.0
9636.26,804,779,25,44,253,0.0
9646.25,802,778,24,44,253,-0.0333
9656.23,804,779,25,44,251,0.0
9666.23,802,777,25,45,252,0.0
9676.23,806,780,26,45,252,0.0
9686.26,804,780,24,44,252,0.0
9696.24,803,780,23,44,252,0.0
9706.26,804,780,24,44,253,0.0
9716.24,803,776,27,43,251,0.0
9726.23,804,781,23,45,253,0.0
9736.23,804,779,25,45,252,0.0
9746.27,803,779,24,44,252,0.0
9756.23,804,779,25,44,252,0.0
9766.23,804,780,24,44,252,0.0
9776.26,805,781,24,44,253,0.0
9786.25,804,780,24,45,252,0.0
9796.23,803,780,23,44,253,0.0
9806.26,811,773,38,45,252,0.0
9816.25,803,779,24,45,252,0.0
9826.26,805,779,26,45,252,0.0
9836.24,803,780,23,44,252,-0.0333
9846.25,806,781,25,44,253,0.0
9856.26,806,780,26,44,252,-0.0333
9866.26,804,779,25,44,252,0.0
9876.25,806,781,25,45,252,0.0
9886.25,804,779,25,44,252,0.0
9896.24,806,783,23,44,253,0.0
9906.23,805,779,26,43,252,0.0
9916.27,805,780,25,44,252,0.0
9926.23,805,779,26,46,252,0.0
9936.24,803,779,24,44,253,0.0
9946.23,803,781,22,44,252,0.0
9956.23,804,779,25,45,252,0.0
9966.24,804,780,24,43,253,0.0
9976.25,805,779,26,43,252,-0.0333
9986.24,802,774,28,43,254,0.0
9996.25,805,780,25,44,251,0.0
10006.23,803,779,24,44,252,0.0
10016.26,806,781,25,45,253,0.0
10026.23,804,780,24,44,252,0.0
10036.23,805,780,25,44,253,0.0
10046.26,803,780,23,44,253,0.0
10056.24,804,779,25,44,252,0.0
10066.23,804,779,25,44,252,0.0
10076.24,805,779,26,44,253,0.0
10086.25,805,780,25,44,253,0.0
10096.26,805,780,25,44,253,0.0
10106.23,803,779,24,44,252,0.0333
10116.25,804,781,23,44,253,0.0
10126.23,806,780,26,45,252,0.0
10136.24,804,779,25,44,252,0.0
10146.24,804,779,25,45,252,0.0
10156.25,805,779,26,45,252,0.0
10166.24,810,784,26,43,254,0.0
10176.23,803,777,26,45,252,0.0
10186.25,805,781,24,45,253,0.0
10196.23,805,779,26,45,252,0.0
10206.23,804,779,25,45,253,0.0
10216.26,802,779,23,44,253,0.0
10226.24,804,780,24,45,252,0.0
10236.23,809,784,25,44,255,0.0
10246.23,803,779,24,44,252,0.0
10256.23,808,784,24,44,253,0.0
10266.26,805,778,27,44,251,0.0
10276.24,804,779,25,44,252,0.0
10286.26,805,781,24,45,253,0.0
10296.24,805,780,25,45,252,0.0
10306.23,800,775,25,43,251,0.0
10316.24,805,780,25,43,251,0.0
10326.23,805,780,25,45,252,0.0
10336.26,803,779,24,43,252,0.0
10346.23,802,784,18,43,253,0.0
10356.23,804,781,23,45,253,0.0
10366.27,804,780,24,45,252,0.0
10376.24,804,779,25,43,252,0.0
10386.24,805,779,26,44,253,0.0333
10396.23,803,778,25,44,252,0.0
10406.24,808,785,23,44,254,0.0
10416.23,804,779,25,44,252,0.0
10426.25,805,780,25,44,252,0.0
10436.26,807,779,28,44,252,0.0
10446.24,804,779,25,44,252,0.0
10456.23,804,779,25,44,252,0.0
10466.23,804,779,25,44,253,0.0
10476.23,809,780,29,44,252,0.0
10486.24,803,779,24,45,253,0.0
10496.25,804,780,24,45,252,0.0
10506.23,805,778,27,44,252,0.0
10516.23,804,780,24,44,252,0.0
10526.23,804,780,24,43,251,0.0
10536.23,803,780,23,45,252,0.0
10546.23,806,779,27,44,252,0.0
10556.24,805,779,26,44,252,0.0
10566.24,804,779,25,44,252,0.0
10576.24,809,784,25,43,253,0.0
10586.23,804,779,25,44,252,0.0
10596.25,806,780,26,45,253,0.0
10606.23,805,778,27,45,252,0.0
10616.24,805,779,26,45,254,0.0
10626.23,804,780,24,44,253,0.0
10636.23,804,779,25,44,252,0.0
10646.24,803,780,23,45,252,0.0333
10656.23,804,779,25,45,252,-0.0333
10666.26,806,780,26,43,252,-0.0333
10676.26,804,779,25,46,252,-0.0333
10686.24,804,779,25,45,252,0.0
10696.26,805,778,27,46,252,0.0
10706.23,799,781,18,44,252,0.0
10716.23,803,779,24,45,253,0.0
10726.25,804,779,25,45,252,0.0
10736.25,804,779,25,44,252,0.0
10746.27,805,784,21,45,253,0.0
10756.24,803,778,25,43,252,0.0
10766.23,804,780,24,45,253,0.0
10776.26,806,779,27,44,252,0.0
10786.24,805,780,25,45,252,0.0
10796.23,806,784,22,43,252,0.0
10806.25,804,779,25,44,252,0.0
10816.25,808,780,28,44,253,0.0
10826.23,804,779,25,44,253,0.0
10836.23,805,781,24,44,252,0.0
10846.25,805,778,27,43,252,0.0
10856.23,803,779,24,44,252,-0.0333
10866.26,804,780,24,43,252,0.0
10876.25,804,780,24,44,252,0.0
10886.24,802,784,18,43,252,0.0
10896.23,805,777,28,44,252,0.0
10906.23,805,779,26,44,253,0.0
10916.27,803,777,26,45,253,0.0
10926.24,802,779,23,44,252,0.0
10936.23,804,780,24,43,252,0.0
10946.23,805,780,25,45,252,0.0
10956.24,804,779,25,44,252,0.0
10966.23,804,780,24,44,252,0.0
10976.23,805,779,26,45,253,0.0
10986.22,807,786,21,44,254,0.0333
10996.23,803,778,25,43,252,0.0
11006.23,805,780,25,44,252,0.0
11016.23,803,779,24,44,252,0.0
11026.23,805,780,25,44,253,0.0
11036.25,804,779,25,44,252,0.0
11046.23,801,776,25,45,253,0.0333
11056.23,808,781,27,45,253,0.0
11066.23,803,776,27,44,254,0.0
11076.23,806,780,26,45,252,0.0
11086.23,803,779,24,43,251,0.0
11096.22,805,780,25,44,253,0.0
11106.23,804,780,24,45,253,0.0
11116.23,805,780,25,46,252,0.0
11126.22,804,779,25,43,252,0.0
11136.22,806,777,29,45,251,0.0
11146.23,803,779,24,44,252,0.0
11156.23,804,779,25,46,253,0.0
11166.24,803,780,23,44,251,0.0
11176.25,803,778,25,45,252,0.0
11186.23,804,779,25,44,252,0.0
11196.22,803,778,25,44,252,0.0
11206.24,805,780,25,45,252,0.0
11216.24,804,779,25,44,252,0.0
11226.23,807,784,23,43,253,0.0
11236.23,803,780,23,44,252,0.0
11246.23,800,781,19,45,255,0.0
11256.26,803,779,24,43,252,0.0
11266.23,805,779,26,44,252,0.0
11276.23,805,779,26,45,252,0.0
11286.24,804,780,24,44,253,0.0
11296.23,806,780,26,44,252,0.0
11306.23,803,780,23,43,252,0.0
11316.23,804,780,24,43,252,0.0
11326.26,803,778,25,45,252,0.0
11336.24,803,776,27,44,255,-0.0333
11346.23,805,780,25,44,253,0.0
11356.23,804,780,24,45,252,0.0
11366.24,803,779,24,44,252,0.0
11376.23,805,779,26,45,252,0.0
11386.23,803,780,23,44,253,0.0
11396.23,807,785,22,45,254,-0.0333
11406.24,804,779,25,44,253,0.0
11416.25,803,777,26,45,253,0.0
11426.23,805,780,25,45,252,0.0
11436.22,804,779,25,45,252,0.0
11446.26,805,779,26,44,252,0.0
11456.23,803,779,24,44,253,0.0
11466.24,808,781,27,43,253,0.0
11476.23,804,780,24,44,252,0.0
11486.23,804,779,25,44,252,0.0
11496.25,803,778,25,45,252,0.0
11506.23,804,779,25,44,252,0.0
11516.23,805,777,28,45,252,0.0
11526.23,804,780,24,45,252,0.0
11536.23,803,780,23,45,252,0.0
11546.25,804,779,25,45,252,0.0
11556.24,803,780,23,44,252,0.0
11566.23,808,784,24,44,254,0.0
11576.24,803,779,24,45,252,0.0
11586.23,805,781,24,45,252,0.0
11596.23,804,779,25,44,252,0.0
11606.24,804,779,25,44,254,0.0
11616.23,805,779,26,44,252,0.0
11626.25,805,780,25,44,252,0.0
11636.23,808,781,27,44,253,0.0
11646.23,803,779,24,44,252,0.0
11656.23,804,780,24,44,252,0.0
11666.23,802,778,24,45,251,0.0
11676.24,803,778,25,43,252,0.0
11686.25,804,779,25,45,252,0.0
11696.26,806,781,25,45,251,0.0
11706.23,804,779,25,44,253,0.0
11716.25,804,779,25,45,252,0.0
11726.23,803,779,24,43,252,0.0
11736.23,808,784,24,44,254,0.0
11746.24,802,778,24,44,252,0.0
11756.23,805,781,24,45,253,0.0
11766.26,804,778,26,45,251,0.0
11776.24,804,779,25,45,251,0.0
11786.23,799,773,26,44,251,0.0
11796.23,802,779,23,44,252,0.0
11806.25,806,780,26,43,252,0.0
11816.24,803,778,25,44,250,-0.0333
11826.23,805,779,26,44,253,-0.0333
11836.23,803,777,26,45,251,0.0
11846.24,803,779,24,44,252,0.0
11856.25,803,780,23,43,253,0.0
11866.23,804,779,25,44,252,0.0
11876.25,803,774,29,44,251,0.0
11886.23,806,775,31,45,252,-0.0333
11896.23,804,779,25,43,253,-0.0333
11906.25,804,779,25,44,252,0.0
11916.23,802,778,24,44,252,0.0
11926.23,803,777,26,44,252,0.0
11936.27,802,779,23,45,252,0.0
11946.24,801,779,22,44,251,0.0
11956.25,803,779,24,44,252,-0.0333
11966.23,802,785,17,45,252,0.0
11976.25,808,783,25,45,254,0.0
11986.24,803,779,24,44,252,0.0
11996.25,803,779,24,45,253,0.0
12006.26,803,777,26,43,251,0.0
12016.24,804,779,25,45,252,0.0
12026.26,804,779,25,45,252,0.0
12036.25,803,778,25,45,253,0.0
12046.25,805,778,27,44,251,-0.0333
12056.23,802,773,29,44,252,0.0
12066.26,803,779,24,45,252,0.0
12076.26,803,778,25,44,251,0.0
12086.23,803,779,24,44,252,0.0
12096.23,805,779,26,45,253,0.0
12106.26,804,779,25,44,252,-0.0333
12116.23,803,779,24,44,252,0.0
12126.23,803,779,24,44,252,0.0
12136.23,804,780,24,44,252,0.0
12146.23,809,784,25,45,254,0.0
12156.23,803,778,25,45,252,-0.0333
12166.25,804,779,25,45,252,0.0
12176.23,802,779,23,45,252,0.0
12186.24,804,777,27,44,252,0.0
12196.23,803,778,25,44,252,0.0
12206.23,802,779,23,44,251,0.0
12216.24,807,779,28,44,252,0.0
12226.23,803,778,25,44,252,-0.0333
12236.23,804,783,21,44,252,0.0
12246.26,802,778,24,45,251,0.0
12256.23,802,778,24,45,252,0.0
12266.23,803,779,24,45,252,0.0
12276.23,802,778,24,45,252,0.0
12286.23,802,778,24,44,252,0.0
12296.24,802,779,23,43,252,0.0
12306.25,803,778,25,44,252,0.0
12316.23,807,784,23,44,254,0.0
12326.23,803,779,24,45,251,0.0
12336.23,805,779,26,45,252,0.0
12346.23,804,778,26,44,252,0.0
12356.24,803,778,25,44,251,0.0
12366.25,803,778,25,45,251,0.0
12376.23,803,778,25,44,252,0.0
12386.24,807,780,27,43,253,0.0
12396.23,802,778,24,44,252,0.0
12406.23,805,779,26,43,252,0.0
12416.23,803,777,26,45,252,0.0
12426.24,803,778,25,44,252,0.0
12436.23,804,779,25,45,252,0.0
12446.27,802,779,23,45,252,0.0
12456.23,802,778,24,44,252,0.0
12466.23,803,778,25,44,252,0.0
12476.23,803,778,25,44,252,-0.0333
12486.24,808,784,24,45,254,0.0
12496.24,803,779,24,45,252,0.0
12506.25,803,776,27,44,250,0.0
12516.26,803,779,24,45,252,0.0
12526.23,804,779,25,45,252,0.0
12536.23,803,778,25,44,252,0.0
12546.23,804,779,25,45,252,0.0
12556.24,805,779,26,44,252,0.0
12566.23,803,778,25,44,252,0.0
12576.25,804,779,25,44,252,0.0
12586.23,803,777,26,46,252,0.0
12596.24,801,773,28,44,252,0.0
12606.25,804,779,25,44,253,-0.0333
12616.23,803,780,23,45,252,0.0
12626.23,802,778,24,43,252,0.0
12636.24,806,776,30,44,250,0.0
12646.26,803,779,24,45,252,0.0
12656.25,804,778,26,45,252,0.0
12666.23,803,779,24,43,252,0.0
12676.23,804,779,25,45,251,0.0
12686.28,805,780,25,45,253,0.0
12696.23,803,778,25,45,252,0.0
12706.24,804,778,26,44,252,0.0
12716.23,802,778,24,45,252,0.0
12726.23,808,783,25,44,253,0.0
12736.23,800,778,22,44,252,0.0
12746.23,805,779,26,45,252,0.0
12756.26,803,778,25,44,252,0.0333
12766.24,804,778,26,45,251,0.0
12776.23,804,780,24,44,253,0.0
12786.23,805,779,26,44,252,0.0
12796.24,804,779,25,43,252,0.0
12806.23,802,778,24,45,252,0.0
12816.23,803,778,25,44,252,0.0
12826.25,802,777,25,45,252,0.0
12836.24,801,779,22,45,252,0.0
12846.26,803,779,24,46,252,0.0
12856.27,804,779,25,45,252,0.0
12866.24,802,774,28,44,252,0.0
12876.23,803,779,24,44,252,0.0
12886.23,801,779,22,44,252,0.0
12896.23,808,783,25,45,253,0.0
12906.23,801,778,23,45,252,0.0
12916.23,803,779,24,45,251,0.0
12926.27,803,780,23,46,252,0.0333
12936.23,803,779,24,43,252,0.0
12946.26,805,779,26,44,252,0.0
12956.25,802,772,30,43,252,0.0
12966.24,802,778,24,44,252,0.0
12976.23,803,778,25,44,252,0.0
12986.23,804,778,26,44,252,0.0
12996.26,804,778,26,44,252,0.0
13006.24,803,778,25,44,252,0.0
13016.25,803,779,24,46,251,0.0
13026.23,804,780,24,45,252,0.0
13036.23,802,778,24,44,252,0.0
13046.23,800,779,21,45,252,0.0
13056.23,801,775,26,44,252,0.0
13066.24,807,783,24,44,254,0.0
13076.24,802,778,24,45,252,0.0
13086.26,803,780,23,44,252,0.0
13096.26,803,777,26,44,252,0.0
13106.23,803,779,24,44,252,0.0
13116.25,803,778,25,44,252,0.0
13126.23,803,777,26,44,252,-0.0333
13136.24,808,784,24,45,253,0.0
13146.24,802,778,24,44,251,0.0
13156.25,803,779,24,45,252,0.0
13166.23,803,777,26,45,251,0.0
13176.25,803,778,25,44,252,0.0
13186.25,803,779,24,45,252,-0.0333
13196.24,803,779,24,44,251,0.0
13206.24,803,778,25,44,252,0.0
13216.24,801,776,25,43,251,0.0
13226.25,799,779,20,45,252,0.0
13236.23,803,780,23,44,252,0.0
13246.23,803,779,24,44,252,0.0
13256.24,803,779,24,44,252,0.0
13266.26,804,780,24,45,252,0.0
13276.24,802,778,24,44,251,0.0
13286.24,804,778,26,44,252,0.0
13296.24,802,778,24,45,251,0.0
13306.23,807,784,23,44,253,0.0
13316.24,802,777,25,44,252,0.0
13326.25,804,780,24,44,253,0.0
13336.26,803,778,25,44,252,0.0
13346.24,804,779,25,44,252,0.0
13356.23,803,778,25,44,252,0.0
13366.23,803,779,24,44,252,0.0
13376.23,806,780,26,45,251,0.0
13386.23,801,778,23,43,252,0.0
13396.25,804,780,24,44,252,0.0
13406.26,803,775,28,45,253,0.0
13416.24,802,778,24,44,252,0.0
13426.23,802,779,23,44,251,0.0
13436.23,805,779,26,45,253,0.0
13446.23,801,777,24,44,252,0.0
13456.23,802,778,24,44,252,0.0
13466.23,803,779,24,44,252,0.0
13476.23,808,783,25,45,254,0.0
13486.24,801,778,23,44,253,0.0
13496.25,801,776,25,45,252,0.0
13506.26,804,779,25,44,251,0.0
13516.24,803,778,25,45,252,0.0
13526.23,803,778,25,45,252,0.0
13536.24,802,777,25,45,253,0.0
13546.24,803,780,23,45,252,0.0
13556.24,802,778,24,44,252,0.0
13566.23,804,779,25,44,252,0.0
13576.23,802,777,25,45,251,0.0
13586.24,803,773,30,45,252,0.0
13596.25,803,779,24,44,252,0.0
13606.27,803,779,24,44,252,0.0
13616.23,801,779,22,44,252,-0.0333
13626.23,802,779,23,45,251,0.0
13636.25,804,780,24,44,252,0.0
13646.23,808,784,24,44,254,0.0
13656.24,802,778,24,44,252,0.0
13666.23,804,779,25,44,253,0.0
13676.23,804,779,25,44,252,0.0
13686.24,803,776,27,46,252,0.0
13696.23,803,778,25,44,252,0.0
13706.23,803,778,25,43,252,0.0
13716.24,804,779,25,44,251,0.0
13726.23,802,779,23,44,252,0.0
13736.23,805,779,26,45,252,0.0
13746.23,803,777,26,45,252,0.0
13756.23,803,779,24,44,252,0.0
13766.23,804,774,30,45,253,0.0
13776.23,804,779,25,44,252,0.0
13786.24,803,779,24,44,252,0.0
13796.24,803,778,25,44,252,-0.0333
13806.23,804,778,26,45,253,0.0
13816.23,807,784,23,45,253,0.0
13826.23,804,778,26,44,252,0.0
13836.26,803,780,23,45,253,0.0
13846.23,805,778,27,45,251,0.0
13856.23,805,779,26,45,254,0.0
13866.26,804,779,25,43,252,0.0
13876.24,803,779,24,44,252,0.0
13886.25,809,781,28,44,252,0.0
13896.24,804,779,25,45,252,0.0
13906.23,804,779,25,44,252,0.0
13916.26,804,779,25,45,252,0.0
13926.23,804,780,24,43,252,0.0
13936.25,803,779,24,46,252,0.0
13946.27,804,780,24,46,252,0.0
13956.22,802,780,22,44,253,-0.0333
13966.23,804,780,24,43,253,0.0
13976.23,803,779,24,45,252,0.0
13986.25,810,784,26,44,254,0.0
13996.23,804,779,25,44,253,0.0
14006.25,805,781,24,45,253,0.0
14016.26,804,779,25,45,252,0.0
14026.23,804,779,25,43,252,0.0
14036.25,800,776,24,43,250,0.0
14046.23,803,779,24,43,252,0.0
14056.23,808,781,27,44,252,0.0
14066.23,803,779,24,43,252,0.0
14076.23,804,780,24,44,252,0.0
14086.23,803,778,25,45,252,0.0
14096.24,803,779,24,44,252,0.0
14106.26,804,780,24,45,252,0.0
14116.25,804,779,25,45,252,0.0
14126.23,803,773,30,44,252,0.0
14136.23,803,777,26,45,253,0.0
14146.26,803,779,24,44,252,0.0
14156.23,804,781,23,45,253,0.0
14166.24,802,779,23,44,252,0.0
14176.25,803,779,24,45,252,0.0
14186.23,805,780,25,44,252,-0.0333
14196.23,801,777,24,43,253,0.0
14206.24,804,780,24,44,252,0.0
14216.23,803,776,27,45,252,0.0
14226.23,808,784,24,45,254,0.0
14236.23,802,779,23,43,253,0.0
14246.23,803,780,23,46,253,0.0
14256.23,804,779,25,45,252,0.0
14266.24,804,779,25,44,251,0.0
14276.25,801,779,22,44,252,0.0
14286.23,807,779,28,44,252,0.0
14296.23,804,780,24,44,252,0.0
14306.25,802,780,22,44,253,0.0
14316.23,801,777,24,44,252,-0.0333
14326.23,801,779,22,44,252,0.0
14336.23,803,779,24,45,252,0.0
14346.25,805,779,26,44,253,0.0
14356.27,805,781,24,45,252,0.0
14366.23,803,779,24,45,252,0.0
14376.25,800,778,22,44,252,0.0
14386.23,804,779,25,45,252,0.0
14396.23,806,791,15,44,254,0.0
14406.23,803,779,24,43,252,0.0
14416.23,805,780,25,44,253,0.0
14426.23,803,779,24,44,252,0.0
14436.23,804,780,24,44,252,0.0
14446.23,805,779,26,44,252,0.0
14456.24,803,779,24,44,253,0.0
14466.25,806,780,26,43,253,0.0
14476.24,803,779,24,44,252,0.0
14486.23,807,774,33,43,251,0.0
14496.23,803,778,25,45,252,0.0
14506.24,803,780,23,43,253,0.0
14516.27,803,780,23,45,253,0.0
14526.23,803,780,23,44,252,0.0
14536.23,803,780,23,43,253,0.0
14546.23,804,779,25,46,252,0.0
14556.23,804,780,24,45,253,0.0
14566.23,808,784,24,44,254,0.0
14576.23,803,780,23,44,252,0.0
14586.26,804,780,24,44,252,0.0
14596.23,805,778,27,46,252,0.0
14606.24,804,780,24,44,252,0.0
14616.26,802,779,23,44,253,0.0
14626.25,805,779,26,44,252,0.0
14636.23,807,780,27,44,252,0.0
14646.25,803,779,24,44,252,0.0
14656.23,804,779,25,44,252,0.0
14666.26,800,779,21,44,252,0.0
14676.25,803,779,24,44,252,0.0
14686.23,803,780,23,46,252,0.0
14696.23,804,780,24,44,252,0.0
14706.24,803,779,24,45,252,0.0
14716.23,803,779,24,44,253,0.0
14726.23,803,779,24,44,253,0.0
14736.23,808,784,24,45,254,0.0
14746.23,802,779,23,44,252,0.0
14756.25,807,775,32,45,253,0.0
14766.26,805,779,26,44,251,0.0
14776.23,805,779,26,43,252,0.0
14786.23,804,779,25,45,252,0.0
14796.22,803,779,24,44,253,0.0
14806.23,806,780,26,44,253,0.0
14816.24,803,779,24,45,252,0.0
14826.24,804,780,24,43,252,0.0
14836.23,804,778,26,44,252,0.0
14846.23,803,774,29,44,252,0.0
14856.23,804,779,25,45,253,0.0
14866.23,804,780,24,43,253,0.0
14876.24,804,779,25,43,252,0.0
14886.22,802,776,26,44,252,0.0
14896.25,803,779,24,43,252,0.0
14906.26,805,781,24,44,252,0.0
14916.25,802,779,23,43,252,0.0
14926.25,804,781,23,45,252,0.0
14936.23,804,778,26,44,252,0.0
14946.24,803,779,24,44,252,0.0
14956.25,804,779,25,44,251,0.0
14966.23,804,779,25,44,252,0.0
14976.23,808,785,23,43,253,0.0
14986.24,804,779,25,44,252,0.0
14996.25,805,781,24,44,253,0.0
15006.27,805,779,26,46,252,0.0
15016.24,804,780,24,44,252,0.0
15026.23,804,777,27,45,251,0.0
15036.23,805,779,26,46,253,0.0
15046.24,804,780,24,43,252,0.0
15056.23,803,779,24,45,252,-0.0333
15066.23,805,779,26,44,252,0.0
15076.25,803,779,24,45,252,0.0
15086.23,804,780,24,43,253,0.0
15096.25,805,777,28,44,253,0.0
15106.23,804,780,24,44,252,0.0
15116.24,804,777,27,44,250,0.0
15126.23,802,779,23,45,253,0.0
15136.23,804,779,25,45,252,0.0
15146.26,805,784,21,43,254,0.0
15156.24,803,779,24,43,252,0.0
15166.23,803,780,23,45,253,0.0
15176.23,807,778,29,45,252,-0.0333
15186.23,805,780,25,44,252,0.0
15196.23,803,779,24,46,252,0.0
15206.24,804,774,30,44,250,0.0
15216.24,805,780,25,44,252,0.0
15226.23,805,780,25,44,252,0.0
15236.23,804,780,24,44,253,0.0
15246.26,804,779,25,46,251,0.0
15256.24,804,779,25,44,252,0.0
15266.26,804,780,24,45,253,0.0
15276.23,805,780,25,44,252,0.0
15286.24,803,780,23,44,252,0.0
15296.23,799,780,19,45,252,0.0
15306.23,804,780,24,45,252,0.0
15316.23,808,784,24,45,254,0.0
15326.23,802,779,23,43,253,0.0
15336.25,804,780,24,45,253,0.0
15346.23,804,779,25,45,251,0.0
15356.24,804,779,25,44,252,0.0
15366.26,804,780,24,45,252,0.0
15376.23,804,780,24,43,252,-0.0333
15386.24,808,774,34,44,253,0.0
15396.23,803,779,24,44,253,0.0
15406.23,804,780,24,44,252,0.0
15416.26,803,779,24,44,252,0.0
15426.23,803,779,24,44,252,0.0
15436.26,803,780,23,45,252,0.0
15446.27,805,780,25,44,253,0.0
15456.23,801,778,23,44,252,0.0
15466.24,804,779,25,44,252,0.0
15476.25,802,776,26,44,254,0.0
15486.23,808,784,24,44,254,0.0
15496.23,803,779,24,44,252,0.0
15506.25,805,781,24,45,253,0.0
15516.27,803,779,24,45,253,0.0
15526.24,804,780,24,43,252,0.0
15536.23,804,779,25,43,252,0.0
15546.25,804,779,25,44,253,0.0
15556.23,808,781,27,43,253,0.0
15566.23,803,781,22,44,252,0.0
15576.23,803,779,24,44,253,0.0
15586.23,803,778,25,45,252,0.0
15596.23,804,779,25,44,252,0.0
15606.26,805,780,25,45,253,0.0
15616.24,805,780,25,44,252,0.0
15626.24,801,778,23,44,252,0.0
15636.24,804,780,24,44,252,0.0
15646.25,802,779,23,44,252,0.0
15656.23,815,784,31,44,255,0.0
15666.24,803,778,25,44,252,0.0
15676.23,803,781,22,45,253,0.0
15686.23,803,781,22,45,252,0.0
15696.24,801,778,23,44,253,0.0
15706.23,804,780,24,45,252,0.0
15716.23,803,779,24,43,253,0.0
15726.23,806,784,22,44,253,-0.0333
15736.23,803,779,24,45,252,0.0
15746.23,805,779,26,45,254,0.0
15756.23,806,779,27,46,252,0.0
15766.23,804,779,25,45,252,0.0
15776.23,806,779,27,45,252,0.0
15786.25,803,780,23,44,252,-0.0333
15796.23,803,780,23,43,252,0.0
15806.23,802,779,23,45,253,0.0
15816.23,805,778,27,45,253,0.0
15826.23,804,778,26,44,252,0.0
15836.24,803,782,21,43,251,0.0
15846.25,805,780,25,43,252,0.0
15856.23,805,780,25,44,251,0.0
15866.24,803,779,24,44,252,0.0
15876.24,804,779,25,44,252,0.0
15886.24,803,780,23,45,252,0.0
15896.23,807,784,23,44,254,0.0
15906.24,803,779,24,44,252,0.0
15916.23,804,780,24,44,252,0.0
15926.27,800,780,20,43,252,0.0
15936.23,805,785,20,44,254,0.0
15946.24,801,777,24,45,252,0.0
15956.24,803,777,26,45,251,0.0
15966.25,804,779,25,43,253,0.0
15976.25,804,779,25,45,252,0.0
15986.24,803,780,23,45,253,0.0
15996.23,805,780,25,45,252,0.0
16006.26,804,780,24,44,252,0.0
16016.23,803,773,30,43,252,0.0
16026.23,803,778,25,44,252,0.0
16036.25,805,779,26,44,252,0.0
16046.23,808,784,24,44,254,0.0
16056.24,803,778,25,45,252,0.0
16066.26,804,780,24,44,253,0.0
16076.23,803,779,24,46,252,0.0
16086.24,806,780,26,44,252,0.0
16096.23,804,779,25,45,252,0.0
16106.25,804,779,25,43,251,0.0
16116.24,807,781,26,43,252,0.0
16126.22,805,779,26,44,252,0.0
16136.26,805,780,25,43,253,-0.0333
16146.25,803,778,25,44,252,0.0
16156.24,803,780,23,43,252,0.0
16166.23,804,780,24,44,252,0.0
16176.26,804,779,25,44,252,0.0
16186.24,803,779,24,44,252,0.0
16196.23,806,784,22,43,252,0.0
16206.25,803,779,24,44,252,0.0
16216.25,808,785,23,44,254,0.0
16226.23,804,778,26,45,252,0.0
16236.23,804,779,25,45,252,0.0
16246.26,804,780,24,45,253,0.0
16256.24,805,779,26,44,252,0.0
16266.26,803,779,24,44,252,-0.0333
16276.23,804,780,24,45,252,0.0
16286.22,805,784,21,44,253,0.0
16296.22,802,780,22,45,252,0.0
16306.26,804,780,24,45,252,0.0
16316.23,804,779,25,45,252,0.0
16326.23,803,779,24,43,253,0.0
16336.26,804,780,24,44,252,0.0
16346.26,804,780,24,45,253,0.0333
16356.24,803,780,23,45,252,0.0
16366.23,803,779,24,44,252,0.0
16376.25,802,780,22,44,253,0.0
16386.24,809,784,25,43,255,0.0
16396.24,802,778,24,45,252,0.0
16406.23,804,780,24,46,252,0.0
16416.23,804,779,25,43,252,0.0
16426.24,803,779,24,45,252,0.0
16436.23,802,778,24,43,252,0.0
16446.24,801,779,22,43,252,0.0
16456.23,807,779,28,44,252,0.0
16466.24,803,778,25,44,253,0.0
16476.23,804,780,24,46,253,0.0
16486.25,803,778,25,44,252,0.0
16496.24,803,779,24,43,253,0.0
16506.26,804,779,25,45,252,0.0
16516.23,804,780,24,45,252,0.0
16526.24,804,779,25,44,252,0.0
16536.23,802,777,25,43,253,0.0
16546.26,805,780,25,44,252,0.0
16556.26,804,774,30,43,250,0.0
16566.24,803,779,24,43,252,0.0333
16576.23,803,781,22,45,252,0.0
16586.23,802,777,25,44,252,0.0
16596.24,799,775,24,44,250,0.0
16606.24,803,777,26,44,252,0.0
16616.25,802,780,22,42,255,0.0
16626.25,803,779,24,44,252,-0.0333
16639.33,802,777,25,44,252,0.0
16646.24,800,777,23,44,251,0.0
16656.23,803,778,25,45,253,0.0
16666.23,800,778,22,43,252,0.0
16676.23,805,778,27,44,251,0.0
16686.23,803,779,24,44,252,0.0
16696.27,803,779,24,43,250,-0.0333
16706.22,801,777,24,44,252,0.0333
16716.23,803,779,24,45,252,0.0
16726.24,801,779,22,43,252,0.0
16736.24,803,780,23,45,252,0.0
16746.23,803,778,25,45,252,0.0
16756.25,799,775,24,45,250,0.0
16766.23,804,779,25,43,252,0.0333
16776.23,804,778,26,44,252,0.0
16786.23,804,780,24,44,252,0.0
16796.23,803,779,24,45,252,0.0
16806.23,803,778,25,44,252,0.0
16816.25,804,779,25,44,252,0.0
16826.23,803,778,25,45,252,0.0
16836.24,803,779,24,44,253,0.0
16846.23,802,778,24,45,253,0.0
16856.23,803,778,25,43,252,0.0
16866.23,803,777,26,45,252,0.0
16876.24,802,779,23,44,252,0.0
16886.24,803,780,23,44,252,0.0
16896.23,803,779,24,44,252,0.0
16906.25,802,778,24,43,252,0.0
16916.23,799,779,20,44,252,0.0
16926.24,803,778,25,44,252,0.0
16936.22,807,784,23,44,254,0.0
16946.24,802,778,24,43,251,0.0
16956.25,804,779,25,44,253,0.0
16966.26,803,777,26,43,252,0.0
16976.23,805,779,26,45,252,0.0
16986.23,802,778,24,45,252,0.0
16996.23,802,779,23,44,252,0.0
17006.24,806,775,31,43,250,0.0
17016.23,802,778,24,45,252,0.0
17026.23,802,779,23,44,252,0.0
17036.26,803,777,26,45,252,0.0
17046.23,802,778,24,44,252,0.0
17056.25,804,779,25,44,252,0.0
17066.24,802,779,23,45,252,0.0
17076.25,801,777,24,45,252,0.0333
17086.23,801,776,25,44,252,0.0
17096.26,804,774,30,45,254,0.0
17106.25,803,780,23,45,253,0.0
17116.25,802,778,24,43,252,-0.0333
17126.23,803,779,24,44,253,0.0
17136.26,803,779,24,44,252,0.0
17146.23,802,778,24,44,252,0.0
17156.24,803,778,25,45,252,0.0
17166.23,803,779,24,44,252,0.0
17176.22,806,783,23,45,254,0.0
17186.25,807,777,30,44,253,0.0
17196.23,803,778,25,45,252,0.0
17206.23,804,778,26,45,252,0.0
17216.24,802,778,24,44,251,0.0
17226.23,804,778,26,44,252,0.0
17236.23,803,778,25,44,252,0.0
17246.23,803,780,23,44,252,0.0
17256.24,803,778,25,43,252,0.0
17266.23,803,780,23,43,252,0.0
17276.26,796,776,20,44,251,0.0
17286.23,803,779,24,45,252,0.0
17296.25,803,780,23,45,252,-0.0333
17306.24,800,779,21,44,252,0.0
17316.23,801,779,22,44,251,0.0333
17326.23,803,778,25,44,252,0.0
17336.25,802,779,23,45,252,0.0
17346.25,803,782,21,44,253,0.0
17356.23,802,778,24,45,252,0.0
17366.23,805,773,32,45,252,0.0
17376.23,805,778,27,45,252,0.0
17386.23,804,779,25,45,252,-0.0333
17396.25,803,778,25,45,251,0.0
17406.25,801,778,23,44,252,0.0
17416.22,807,779,28,45,252,0.0
17426.23,801,779,22,45,251,0.0
17436.26,803,779,24,44,252,0.0333
17446.23,803,776,27,44,251,0.0
17456.23,802,780,22,43,252,0.0
17466.25,802,780,22,45,252,0.0
17476.23,803,779,24,44,252,0.0
17486.23,803,779,24,44,252,0.0
17496.22,803,776,27,44,250,0.0
17506.23,803,779,24,43,252,0.0
17516.25,802,778,24,45,253,0.0
17526.23,802,779,23,45,252,0.0
17536.23,804,779,25,45,253,-0.0333
17546.27,803,779,24,44,252,0.0
17556.23,802,779,23,44,252,0.0
17566.23,803,779,24,43,252,0.0
17576.23,803,779,24,44,252,0.0
17586.23,808,784,24,45,254,0.0
17596.24,801,778,23,43,252,0.0
17606.26,803,780,23,46,252,0.0
17616.26,804,777,27,46,252,0.0
17626.24,804,779,25,45,252,0.0
17636.23,810,783,27,45,254,0.0
17646.24,801,779,22,44,252,0.0
17656.23,807,780,27,44,252,0.0
17666.22,802,778,24,45,252,0.0
17676.25,804,779,25,44,252,0.0
17686.26,803,776,27,44,251,0.0
17696.24,802,778,24,44,252,0.0
17706.23,804,779,25,44,252,0.0
17716.23,804,780,24,45,252,0.0
17726.22,804,777,27,43,251,0.0
17736.25,802,777,25,43,251,0.0
17746.23,804,779,25,43,252,0.0
17756.23,803,777,26,45,252,0.0
17766.23,802,778,24,44,251,0.0
17776.23,804,779,25,45,253,0.0
17786.24,803,780,23,45,252,0.0
17796.23,802,778,24,42,252,0.0
17806.23,804,779,25,45,252,0.0
17816.25,803,780,23,45,252,0.0
17826.26,807,783,24,43,254,0.0
17836.23,802,778,24,43,253,0.0333
17846.23,803,779,24,44,252,0.0
17856.27,805,778,27,43,252,0.0
17866.25,804,780,24,44,252,0.0
17876.26,803,778,25,45,251,0.0
17886.23,802,779,23,44,252,0.0
17896.23,804,780,24,45,252,0.0
17906.24,803,778,25,43,252,0.0333
17916.26,804,779,25,44,252,0.0
17926.23,803,777,26,44,251,0.0
17936.24,803,779,24,45,252,0.0
17946.23,802,780,22,45,252,0.0
17956.23,803,780,23,44,251,0.0
17966.22,802,778,24,43,252,0.0
17976.25,803,778,25,44,252,0.0
17986.25,802,779,23,44,253,0.0
17996.23,808,782,26,45,251,0.0
18006.24,803,778,25,45,252,0.0
18016.23,800,779,21,45,253,0.0
18026.23,803,777,26,45,252,0.0
18036.24,805,779,26,44,252,0.0
18046.23,803,777,26,44,252,0.0
18056.24,802,779,23,44,252,0.0
18066.23,808,780,28,44,252,0.0
18076.23,802,778,24,43,252,0.0
18086.23,802,781,21,46,253,0.0
18096.25,802,777,25,44,252,0.0
18106.24,802,779,23,45,252,0.0
18116.25,804,780,24,44,253,0.0
18126.23,802,779,23,45,252,0.0
18136.24,803,779,24,44,252,0.0
18146.24,804,778,26,44,252,0.0
18156.23,803,779,24,45,252,0.0
18166.24,807,784,23,44,253,0.0
18176.23,803,778,25,43,252,0.0
18186.25,804,779,25,45,252,0.0
18196.26,803,779,24,45,251,0.0
18206.23,801,778,23,45,252,0.0
18216.26,800,779,21,45,252,0.0
18226.25,803,779,24,44,251,0.0
18236.23,806,780,26,44,252,0.0
18246.23,802,778,24,45,252,0.0
18256.23,803,778,25,45,252,0.0
18266.23,800,783,17,43,252,0.0
18276.24,802,778,24,44,252,0.0
18286.23,803,779,24,45,252,0.0
18296.23,803,779,24,44,252,0.0
18306.24,802,778,24,43,252,0.0
18316.24,803,778,25,43,252,0.0
18326.38,803,778,25,44,252,0.0
18336.23,807,784,23,45,254,0.0
18346.23,802,778,24,44,252,0.0
18356.25,804,775,29,44,252,0.0
18366.23,804,777,27,44,251,0.0
18376.23,802,778,24,44,252,-0.0333
18386.23,803,777,26,44,252,0.0
18396.23,803,779,24,44,252,0.0
18406.24,808,780,28,44,252,0.0
18416.24,802,778,24,44,252,0.0
18426.49,804,779,25,44,252,0.0
18436.25,802,777,25,44,252,0.0
18446.23,803,778,25,43,252,0.0
18456.26,801,779,22,44,252,0.0
18466.23,804,780,24,46,253,0.0
18476.23,802,778,24,45,252,0.0
18486.24,801,777,24,43,252,0.0
18496.23,802,778,24,44,252,0.0
18506.26,803,780,23,44,252,0.0
18516.23,802,778,24,44,252,0.0
18526.23,804,779,25,44,252,0.0
18536.26,803,779,24,45,252,0.0
18546.23,802,778,24,44,252,0.0
18556.23,803,778,25,45,252,0.0
18566.23,802,778,24,44,252,0.0
18576.24,808,783,25,44,253,0.0
18586.23,802,778,24,43,252,0.0
18596.25,803,779,24,45,252,0.0
18606.26,803,778,25,45,251,0.0
18616.23,803,779,24,43,252,0.0
18626.26,799,779,20,45,253,0.0
18636.23,802,779,23,43,252,0.0
18646.23,803,779,24,43,252,0.0
18656.24,802,778,24,44,252,0.0
18666.23,803,779,24,44,252,-0.0333
18676.23,803,777,26,45,252,0.0
18686.23,802,779,23,44,252,0.0
18696.23,804,777,27,46,252,0.0
18706.27,803,779,24,44,251,0.0
18716.24,798,778,20,44,252,0.0
18726.23,803,778,25,45,252,0.0
18736.24,803,778,25,45,252,0.0
18746.23,806,784,22,45,254,0.0
18756.24,802,778,24,44,252,0.0
18766.23,805,779,26,45,253,0.0
18776.27,803,778,25,45,252,0.0
18786.23,803,778,25,43,252,0.0
18796.23,803,779,24,44,251,0.0
18806.23,802,775,27,43,250,0.0
18816.24,804,780,24,45,252,0.0
18826.24,803,778,25,44,251,0.0
18836.23,803,779,24,44,252,0.0
18846.23,803,778,25,45,252,0.0
18856.24,804,779,25,44,252,-0.0333
18866.26,802,780,22,45,253,0.0
18876.23,805,780,25,46,253,0.0
18886.24,803,780,23,44,252,0.0
18896.25,805,783,22,44,252,0.0
18906.25,802,779,23,44,252,0.0
18916.23,810,784,26,46,254,0.0
18926.23,803,779,24,43,252,0.0
18936.23,804,780,24,45,253,0.0
18946.23,804,778,26,44,252,0.0
18956.24,804,780,24,43,251,0.0
18966.23,805,779,26,43,252,0.0
18976.25,804,779,25,44,252,0.0
18986.24,807,779,28,44,251,0.0
18996.23,803,779,24,45,253,0.0
19006.23,804,779,25,45,251,0.0
19016.23,804,779,25,45,252,0.0
19026.23,803,779,24,44,252,0.0
19036.26,805,780,25,45,252,0.0
19046.27,804,780,24,45,252,0.0
19056.22,804,779,25,44,252,0.0
19066.25,803,780,23,44,253,0.0
19076.23,802,779,23,45,251,0.0
19086.24,807,785,22,45,254,0.0
19096.24,803,779,24,45,252,0.0
19106.26,805,780,25,44,252,0.0
19116.23,807,779,28,45,251,0.0
19126.23,805,779,26,44,252,0.0
19136.23,804,779,25,43,252,0.0
19146.25,804,779,25,44,252,0.0
19156.22,809,780,29,44,252,0.0
19166.24,803,778,25,44,253,0.0
19176.23,803,779,24,44,252,0.0
19186.23,804,777,27,44,252,0.0
19196.24,802,779,23,44,252,0.0
19206.23,804,780,24,44,253,0.0
19216.23,803,781,22,45,252,0.0
19226.23,803,779,24,43,251,0.0
19236.23,805,777,28,44,251,0.0
19246.23,804,780,24,44,252,0.0
19256.23,803,779,24,45,252,0.0
19266.24,802,779,23,43,252,0.0
19276.25,805,780,25,44,253,0.0
19286.25,804,781,23,45,252,0.0
19296.22,803,779,24,45,252,0.0
19306.23,804,779,25,45,252,0.0
19316.24,805,780,25,44,252,0.0
19326.23,807,784,23,43,254,0.0
19336.23,804,779,25,44,252,0.0
19346.23,810,782,28,44,254,0.0
19356.23,804,779,25,45,252,0.0
19366.23,803,780,23,44,252,0.0
19376.23,805,779,26,45,252,0.0
19386.22,804,779,25,44,252,0.0
19396.24,803,779,24,44,252,0.0
19406.23,802,779,23,44,252,0.0
19416.23,806,778,28,46,253,0.0
19426.23,803,778,25,45,251,0.0
19436.24,803,780,23,44,253,0.0
19446.25,804,781,23,45,252,0.0
19456.23,804,779,25,44,252,0.0
19466.24,801,777,24,44,252,0.0
19476.25,804,779,25,44,251,0.0
19486.24,803,779,24,44,252,0.0
19496.26,798,776,22,45,252,0.0
19506.25,803,778,25,44,252,0.0
19516.25,804,780,24,44,252,0.0
19526.23,807,783,24,45,252,0.0
19536.23,805,780,25,44,253,0.0
19546.23,804,779,25,44,252,0.0
19556.25,804,779,25,44,252,0.0
19566.22,809,780,29,43,252,0.0
19576.24,803,779,24,43,253,0.0
19586.26,805,780,25,44,252,0.0
19596.26,804,778,26,44,252,0.0
19606.25,804,779,25,45,252,0.0
19616.26,800,783,17,44,251,0.0
19626.27,804,781,23,45,252,0.0
19636.25,805,780,25,44,252,0.0
19646.23,804,780,24,44,252,0.0
19656.24,804,779,25,44,252,0.0
19666.23,808,784,24,45,254,0.0
19676.23,804,779,25,44,252,0.0
19686.23,803,780,23,44,253,0.0
19696.23,804,779,25,45,252,0.0
19706.23,805,780,25,44,253,0.0
19716.26,803,779,24,44,252,0.0333
19726.23,801,779,22,45,253,0.0
19736.24,806,780,26,44,252,0.0
19746.24,803,779,24,44,253,0.0
19756.23,805,780,25,44,253,0.0
19766.25,803,778,25,44,252,0.0
19776.23,803,779,24,43,252,0.0
19786.23,804,780,24,45,253,0.0
19796.23,805,781,24,44,252,0.0
19806.23,803,779,24,43,253,0.0
19816.24,800,779,21,44,252,0.0
19826.24,804,780,24,45,252,0.0
19836.24,807,785,22,44,254,0.0
19846.23,801,778,23,44,252,0.0
19856.23,805,780,25,45,253,0.0
19866.23,804,779,25,45,252,0.0
19876.22,803,780,23,43,253,0.0
19886.25,806,780,26,46,253,0.0
19896.23,803,779,24,45,252,0.0
19906.22,807,780,27,45,253,0.0
19916.23,803,779,24,44,253,0.0
19926.26,805,779,26,46,252,0.0
19936.23,803,778,25,44,252,0.0
19946.23,802,779,23,43,252,0.0
19956.22,804,779,25,45,252,0.0
19966.23,806,778,28,45,252,0.0
19976.25,802,777,25,44,252,0.0
19986.23,803,778,25,43,253,0.0
19996.25,804,780,24,45,252,0.0
20006.23,803,778,25,44,252,-0.0333
20016.25,804,779,25,45,252,0.0
20026.26,804,780,24,45,253,0.0
20036.27,805,780,25,45,252,0.0
20046.23,803,778,25,45,252,0.0
20056.25,802,779,23,44,252,0.0
20066.25,805,786,19,45,253,0.0
20076.24,808,784,24,45,253,0.0
20086.25,804,779,25,45,252,0.0
20096.26,803,780,23,45,253,0.0
20106.23,804,779,25,43,251,0.0
20116.23,804,780,24,44,251,0.0
20126.26,804,779,25,44,252,0.0
20136.23,803,780,23,44,252,0.0
20146.23,805,779,26,44,252,0.0
20156.23,802,778,24,44,252,0.0
20166.24,806,779,27,43,252,0.0
20176.23,804,778,26,45,251,0.0
20186.25,804,779,25,44,252,0.0
20196.23,804,780,24,45,252,0.0
20206.27,804,779,25,46,253,0.0
20216.23,806,779,27,45,252,0.0
20226.23,803,779,24,46,252,0.0
20236.25,803,779,24,44,252,0.0
20246.23,808,785,23,44,252,0.0
20256.24,803,779,24,44,252,0.0
20266.26,806,781,25,44,253,0.0
20276.23,804,778,26,45,253,0.0
20286.23,805,779,26,44,253,0.0
20296.23,802,779,23,44,252,0.0
20306.23,803,779,24,43,252,0.0
20316.24,806,780,26,44,252,0.0
20326.24,804,780,24,45,252,0.0
20336.26,805,783,22,44,252,0.0
20346.23,803,779,24,44,252,0.0
20356.23,804,779,25,44,252,0.0
20366.24,803,780,23,45,252,0.0
20376.23,804,779,25,45,252,0.0
20386.25,802,779,23,44,252,0.0333
20396.25,804,778,26,45,252,0.0
20406.24,803,779,24,43,253,0.0
20416.22,808,783,25,45,254,0.0
20426.23,809,779,30,44,254,0.0
20436.23,804,780,24,45,253,0.0
20446.27,804,779,25,45,252,0.0
20456.22,803,779,24,45,252,0.0
20466.23,806,778,28,44,252,0.0
20476.24,803,780,23,45,252,0.0
20486.25,804,780,24,44,252,0.0
20496.23,803,779,24,44,253,0.0
20506.23,804,780,24,45,252,0.0
20516.25,803,779,24,46,252,0.0
20526.24,802,779,23,44,252,0.0
20536.23,804,778,26,44,252,0.0
20546.23,803,780,23,45,252,0.0
20556.23,803,779,24,43,252,0.0
20566.23,806,779,27,44,253,0.0
20576.25,802,779,23,44,253,0.0
20586.25,808,784,24,44,255,0.0
20596.22,803,779,24,45,252,0.0
20606.23,805,775,30,44,253,0.0
20616.23,804,779,25,46,252,0.0
20626.23,803,779,24,44,252,0.0
20636.23,804,779,25,44,252,0.0
20646.23,803,780,23,43,253,0.0
20656.23,808,780,28,45,252,0.0
20666.24,803,779,24,43,252,0.0
20676.23,805,780,25,44,253,0.0
20686.23,803,778,25,44,251,0.0
20696.25,808,780,28,43,254,0.0
20706.25,805,780,25,43,252,0.0
20716.25,802,779,23,44,252,0.0
20726.24,803,777,26,44,252,0.0
20736.23,800,776,24,45,252,0.0
20746.26,804,779,25,44,252,0.0
20756.23,803,781,22,44,252,0.0
20766.23,805,780,25,44,252,0.0
20776.26,804,778,26,45,252,0.0
20786.23,804,780,24,45,252,0.0
20796.23,803,779,24,45,252,0.0
20806.23,804,779,25,45,252,0.0
20816.24,805,778,27,45,252,0.0
20826.23,808,784,24,45,254,0.0
20836.24,804,779,25,44,252,-0.0333
20846.25,804,781,23,45,252,0.0
20856.23,803,779,24,45,253,0.0
20866.23,805,779,26,44,252,0.0
20876.25,805,783,22,45,252,0.0
20886.25,803,779,24,44,253,0.0
20896.23,804,778,26,44,252,0.0
20906.23,804,779,25,44,252,0.0
20916.23,804,780,24,44,252,0.0
20926.23,803,778,25,45,252,0.0
20936.23,804,779,25,44,252,0.0
20946.23,804,780,24,44,253,0.0
20956.27,805,781,24,45,252,0.0
20966.23,801,778,23,44,253,0.0
20976.23,804,778,26,45,252,0.0
20986.23,801,778,23,45,252,0.0
20996.24,807,784,23,44,253,0.0
21006.24,803,779,24,45,253,0.0
21016.23,804,779,25,44,253,0.0
21026.23,804,779,25,45,252,0.0
21036.23,804,780,24,43,252,0.0
21046.23,801,780,21,44,252,0.0
21056.25,803,784,19,45,255,0.0
21066.24,809,781,28,45,252,0.0
21076.24,803,779,24,44,252,0.0
21086.25,804,780,24,43,253,0.0
21096.26,803,777,26,44,252,0.0
21106.24,804,779,25,44,253,0.0
21116.23,804,779,25,45,253,-0.0333
21126.23,803,780,23,45,252,0.0
21136.23,803,779,24,43,252,0.0
21146.23,802,779,23,45,253,0.0
21156.24,803,780,23,44,253,0.0
21166.23,807,784,23,44,254,0.0
21176.24,803,778,25,44,253,0.0
21186.25,805,780,25,45,253,0.0
21196.23,804,779,25,46,252,0.0
21206.24,802,778,24,44,251,0.0
21216.25,804,777,27,45,252,0.0
21226.23,803,779,24,44,252,0.0
21236.24,805,782,23,43,252,0.0
21246.23,803,778,25,44,252,0.0
21256.26,803,777,26,45,252,0.0
21266.26,804,779,25,44,252,0.0
21276.24,803,779,24,45,252,0.0
21286.25,805,780,25,44,253,0.0
21296.23,805,779,26,45,252,0.0
21306.23,804,779,25,44,253,0.0
21316.24,804,780,24,44,252,0.0
21326.24,803,783,20,44,253,0.0
21336.23,807,786,21,45,254,0.0
21346.24,803,779,24,44,253,0.0
21356.25,805,781,24,45,253,0.0
21366.26,804,779,25,45,251,0.0
21376.23,803,779,24,44,252,0.0
21386.23,804,779,25,44,252,0.0
21396.23,803,780,23,43,252,0.0
21406.24,805,781,24,45,252,0.0
21416.23,802,778,24,45,252,0.0
21426.23,805,781,24,43,253,0.0
21436.26,804,777,27,44,252,0.0
21446.23,803,779,24,45,252,0.0
21456.26,805,781,24,44,253,-0.0333
21466.23,805,781,24,44,252,0.0333
21476.24,803,778,25,43,252,0.0
21486.24,803,776,27,43,251,0.0
21496.23,804,779,25,43,253,0.0
21506.26,800,776,24,45,252,0.0
21516.24,805,780,25,44,252,0.0
21526.26,804,780,24,44,253,0.0
21536.23,804,780,24,44,253,0.0
21546.24,803,779,24,44,252,0.0
21556.24,805,779,26,46,252,0.0
21566.24,804,780,24,44,252,0.0
21576.25,808,784,24,44,253,0.0
21586.23,804,779,25,44,252,0.0
21596.23,805,781,24,44,253,0.0
21606.23,804,779,25,45,252,0.0
21616.24,804,779,25,46,252,0.0
21626.23,804,779,25,45,252,0.0
21636.23,804,779,25,44,252,0.0
21646.24,804,779,25,45,253,0.0
21656.24,803,779,24,43,253,0.0
21666.23,805,780,25,45,253,0.0
21676.23,803,778,25,45,252,0.0
21686.23,804,780,24,44,253,0.0
21696.23,804,779,25,45,252,0.0
21706.24,802,779,23,45,252,0.0
21716.24,805,779,26,45,252,0.0
21726.25,804,779,25,45,252,0.0
21736.25,802,779,23,45,252,0.0
21746.24,806,783,23,44,254,-0.0333
21756.23,803,779,24,43,252,0.0
21766.23,805,780,25,44,252,0.0
21776.23,804,779,25,46,254,0.0
21786.23,805,780,25,45,252,0.0
21796.23,800,777,23,44,251,0.0
21806.24,803,779,24,44,252,0.0
21816.23,807,781,26,44,253,0.0
21826.24,804,779,25,45,252,0.0
21836.23,804,780,24,44,252,0.0
21846.23,804,777,27,44,252,0.0
21856.24,803,779,24,43,252,0.0
21866.26,800,787,13,45,253,0.0
21876.23,804,780,24,45,252,0.0
21886.24,804,779,25,44,253,0.0
21896.23,803,778,25,43,251,0.0
21906.25,805,780,25,44,252,0.0
21916.23,804,779,25,44,252,0.0
21926.24,803,779,24,44,252,0.0
21936.25,805,781,24,44,252,0.0
21946.26,803,780,23,45,253,-0.0333
21956.22,804,779,25,44,253,0.0
21966.23,805,779,26,44,252,0.0
21976.23,803,779,24,43,252,0.0
21986.24,809,784,25,44,253,0.0
21996.23,802,777,25,43,252,0.0
22006.23,804,780,24,44,252,0.0
22016.23,806,778,28,45,251,0.0
22026.23,805,780,25,44,253,0.0
22036.25,804,778,26,45,252,0.0
22046.24,803,783,20,45,252,0.0333
22056.24,808,780,28,45,252,0.0
22066.24,804,780,24,44,252,0.0
22076.23,804,780,24,44,253,0.0
22086.26,803,777,26,45,252,0.0
22096.23,803,780,23,44,253,0.0
22106.23,803,780,23,44,253,0.0333
22116.25,804,779,25,44,252,0.0
22126.24,803,779,24,44,251,0.0
22136.24,801,774,27,45,251,0.0
22146.23,804,779,25,45,252,0.0
22156.23,802,780,22,44,252,0.0
22166.24,804,779,25,43,252,0.0
22176.26,805,780,25,45,253,0.0
22186.23,804,781,23,45,253,0.0
22196.23,804,778,26,44,252,0.0
22206.23,806,779,27,44,252,0.0
22216.25,803,779,24,45,252,0.0
22226.25,809,783,26,46,254,0.0
22236.24,804,780,24,44,252,0.0
22246.25,805,780,25,45,252,0.0
22256.23,806,778,28,44,252,0.0
22266.23,805,780,25,45,252,0.0
22276.25,804,778,26,44,252,0.0
22286.23,804,780,24,44,253,0.0
22296.24,805,780,25,44,252,0.0
22306.24,804,778,26,44,252,0.0
22316.23,797,780,17,44,252,0.0
22326.25,804,778,26,45,251,0.0
22336.24,804,780,24,45,252,0.0
22346.25,805,780,25,44,253,0.0
22356.25,804,780,24,43,252,0.0
22366.24,804,779,25,44,252,0.0
22376.24,802,779,23,45,252,0.0
22386.24,803,779,24,44,253,0.0
22396.23,807,785,22,44,254,0.0
22406.24,800,779,21,43,252,0.0
22416.25,805,780,25,45,253,0.0
22426.27,804,779,25,44,252,0.0
22436.23,805,780,25,45,253,0.0
22446.26,802,779,23,44,252,0.0
22456.24,805,777,28,44,251,0.0
22466.23,809,785,24,45,252,0.0
22476.23,803,779,24,44,251,0.0
22486.23,803,780,23,44,252,0.0
22496.25,804,777,27,44,252,0.0
22506.25,804,779,25,44,252,0.0
22516.23,805,780,25,43,253,0.0
22526.27,804,780,24,44,252,0.0
22536.23,803,780,23,44,252,0.0
22546.23,805,779,26,44,252,0.0
22556.24,803,779,24,43,252,0.0
22566.22,809,784,25,44,254,0.0
22576.23,803,779,24,43,253,0.0
22586.26,805,786,19,45,252,0.0
22596.23,804,779,25,45,252,0.0
22606.24,803,779,24,44,252,0.0
22616.23,804,780,24,46,252,0.0
22626.24,803,779,24,44,252,0.0
22636.24,807,780,27,44,252,0.0
22646.25,803,779,24,45,252,0.0
22656.25,804,779,25,44,252,0.0
22666.23,803,779,24,45,251,0.0
22676.23,804,779,25,45,251,0.0
22686.23,804,780,24,45,252,0.0
22696.23,804,780,24,43,252,0.0
22706.23,804,778,26,44,252,0.0
22716.25,805,779,26,45,252,0.0
22726.25,804,780,24,44,252,0.0
22736.22,808,785,23,43,254,0.0
22746.25,802,777,25,44,252,0.0
22756.26,804,780,24,44,253,0.0
22766.25,799,778,21,44,252,0.0
22776.22,805,780,25,45,252,0.0
22786.23,804,779,25,44,252,0.0
22796.23,804,779,25,44,253,0.0
22806.24,806,780,26,44,253,0.0
22816.24,803,779,24,44,252,0.0
22826.23,804,780,24,45,252,0.0
22836.23,804,778,26,43,252,0.0
22846.24,803,779,24,44,252,0.0
22856.25,807,783,24,43,252,0.0
22866.23,804,779,25,45,252,0.0
22876.23,803,779,24,44,252,0.0
22886.24,801,780,21,44,252,0.0
22896.25,805,779,26,44,252,0.0
22906.25,807,780,27,44,252,0.0
22916.23,804,778,26,44,252,0.0
22926.23,805,780,25,45,252,0.0
22936.23,805,780,25,45,253,0.0
22946.25,810,779,31,45,254,0.0
22956.24,807,779,28,45,252,0.0
22966.23,803,778,25,45,252,0.0
22976.23,807,783,24,44,254,0.0
22986.23,804,779,25,44,252,0.0
22996.26,803,780,23,45,252,0.0
23006.27,803,779,24,45,252,0.0
23016.23,805,779,26,45,251,0.0
23026.23,805,778,27,44,252,0.0
23036.25,804,781,23,44,252,-0.0333
23046.24,804,780,24,45,252,0.0
23056.23,803,778,25,44,253,0.0
23066.23,806,780,26,45,252,0.0
23076.26,805,778,27,45,252,0.0
23086.23,804,780,24,44,252,0.0
23096.25,803,781,22,44,253,0.0
23106.23,805,781,24,44,252,0.0
23116.23,803,779,24,43,252,0.0
23126.23,803,772,31,44,252,0.0333
23136.26,805,779,26,45,252,0.0
23146.26,805,780,25,45,252,0.0
23156.23,805,779,26,44,252,0.0
23166.23,803,780,23,44,252,0.0
23176.26,804,779,25,45,252,0.0
23186.24,803,778,25,44,252,0.0
23196.23,805,779,26,45,252,0.0
23206.24,806,779,27,45,252,0.0
23216.23,808,784,24,45,254,0.0
23226.23,804,778,26,44,252,0.0
23236.25,805,781,24,45,252,0.0
23246.23,804,779,25,44,252,0.0
23256.23,803,778,25,45,252,0.0
23266.23,805,779,26,44,252,0.0
23276.24,805,779,26,44,252,0.0
23286.24,808,780,28,43,253,0.0
23296.24,803,779,24,45,253,0.0
23306.23,805,784,21,45,251,0.0
23316.23,805,777,28,43,252,0.0333
23326.24,803,780,23,44,252,0.0
23336.23,805,777,28,45,253,0.0
23346.27,805,780,25,45,252,0.0
23356.22,806,779,27,45,252,0.0
23366.22,804,778,26,45,251,0.0
23376.25,805,779,26,43,253,0.0
23386.23,808,784,24,44,254,0.0
23396.24,798,778,20,45,250,0.0
23406.23,803,780,23,45,253,0.0
23416.23,804,779,25,45,252,0.0
23426.23,804,780,24,44,252,0.0
23436.26,805,779,26,45,252,0.0
23446.23,804,779,25,45,252,0.0
23456.25,807,779,28,44,252,0.0
23466.23,802,779,23,44,252,0.0
23476.23,805,780,25,45,252,0.0
23486.23,805,772,33,44,250,0.0
23496.23,803,779,24,43,252,0.0
23506.25,803,779,24,44,253,0.0
23516.23,804,781,23,45,252,0.0
23526.24,803,779,24,44,252,0.0
23536.23,806,777,29,43,251,0.0
23546.23,804,779,25,45,252,0.0
23556.23,805,781,24,44,253,0.0
23566.23,803,779,24,44,252,0.0
23576.23,805,780,25,45,253,0.0
23586.23,805,780,25,44,252,0.0
23596.23,803,779,24,43,252,-0.0333
23606.23,803,780,23,44,252,0.0
23616.23,804,779,25,43,252,0.0
23626.24,807,785,22,44,254,0.0
23636.22,803,780,23,44,253,0.0
23646.23,805,781,24,45,252,0.0
23656.26,806,779,27,45,252,0.0
23666.23,805,780,25,44,252,0.0333
23676.23,804,779,25,44,252,0.0
23686.23,805,779,26,44,252,0.0
23696.24,804,780,24,44,252,0.0
23706.24,804,779,25,44,252,0.0
23716.25,805,780,25,45,252,-0.0333
23726.23,804,779,25,44,252,0.0
23736.24,803,780,23,43,252,0.0
23746.23,803,778,25,43,252,0.0
23756.23,804,782,22,43,252,0.0
23766.24,803,777,26,45,252,0.0
23776.25,804,778,26,44,252,0.0
23786.23,803,779,24,44,252,0.0
23796.23,808,784,24,45,255,0.0
23806.23,805,779,26,43,252,0.0
23816.23,804,780,24,44,253,0.0
23826.26,805,778,27,44,252,0.0
23836.23,806,778,28,45,252,0.0
23846.26,796,781,15,45,252,0.0
23856.25,804,780,24,44,252,0.0
23866.24,808,780,28,44,252,0.0
23876.24,804,780,24,44,253,-0.0333
23886.23,805,780,25,44,252,0.0
23896.23,803,778,25,46,253,-0.0333
23906.23,803,779,24,43,252,0.0
23916.25,803,779,24,45,252,0.0
23926.27,805,779,26,45,252,0.0
23936.23,803,778,25,45,253,0.0
23946.23,804,779,25,45,252,0.0
23956.23,805,779,26,44,252,0.0
23966.23,808,785,23,45,254,0.0
23976.23,803,779,24,43,252,0.0
23986.23,805,780,25,45,253,0.0
23996.27,804,779,25,43,251,0.0
24006.23,803,780,23,44,251,0.0
24016.26,805,779,26,44,252,0.0
24026.24,804,784,20,44,252,0.0
24036.24,807,781,26,44,252,0.0
24046.24,804,779,25,44,253,0.0
24056.26,805,779,26,44,252,0.0
24066.26,803,778,25,44,252,0.0
24076.23,804,779,25,43,252,0.0
24086.26,805,780,25,45,252,0.0
24096.27,804,780,24,44,252,0.0
24106.24,804,779,25,44,253,0.0
24116.24,799,780,19,44,254,0.0
24126.23,805,779,26,44,252,0.0
24136.23,809,785,24,45,254,0.0
24146.23,804,779,25,44,252,0.0
24156.23,806,780,26,44,253,0.0
24166.23,805,779,26,45,251,0.0
24176.23,804,779,25,45,252,0.0
24186.23,805,779,26,44,252,0.0
24196.25,803,779,24,44,252,0.0
24206.24,807,780,27,44,253,0.0
24216.23,803,779,24,44,252,0.0
24226.23,805,780,25,45,252,0.0
24236.26,804,778,26,45,251,-0.0333
24246.23,804,779,25,44,252,0.0
24256.26,806,779,27,44,252,0.0
24266.23,804,780,24,44,252,0.0
24276.24,802,778,24,44,252,0.0
24286.23,801,779,22,44,252,0.0
24296.26,800,780,20,45,252,0.0
24306.23,803,781,22,44,253,0.0
24316.24,805,780,25,44,252,0.0
24326.26,805,781,24,44,253,0.0
24336.23,804,780,24,44,252,0.0
24346.24,804,779,25,43,252,0.0
24356.24,803,780,23,44,252,0.0
24366.24,803,778,25,43,252,0.0
24376.24,807,784,23,45,254,0.0
24386.23,808,779,29,46,254,0.0
24396.25,805,781,24,44,253,0.0
24406.27,805,779,26,44,252,0.0
24416.23,805,779,26,43,252,0.0
24426.25,805,779,26,44,252,0.0
24436.23,804,779,25,44,252,0.0
24446.24,806,779,27,45,252,0.0
24456.23,802,779,23,43,252,0.0
24466.23,804,779,25,44,253,0.0
24476.26,805,780,25,43,254,0.0
24486.24,804,780,24,44,252,0.0
24496.26,804,780,24,46,253,0.0
24506.23,803,779,24,45,253,0.0
24516.23,803,778,25,44,251,0.0
24526.23,804,779,25,43,252,0.0
24536.25,804,780,24,45,252,0.0
24546.26,804,780,24,45,251,0.0
24556.23,803,779,24,44,252,0.0
24566.23,807,779,28,45,253,0.0
24576.23,805,781,24,45,252,0.0
24586.23,805,779,26,44,252,0.0
24596.24,805,780,25,45,252,0.0
24606.25,806,778,28,44,252,0.0
24616.25,808,785,23,44,254,0.0
24626.24,804,779,25,44,252,0.0
24636.23,801,779,22,44,252,0.0
24646.26,803,778,25,45,252,0.0
24656.24,805,787,18,45,252,0.0
24666.23,805,779,26,44,252,0.0
24676.22,804,779,25,44,252,0.0
24686.24,807,780,27,45,252,0.0
24696.22,804,779,25,45,253,0.0
24706.26,803,780,23,45,253,0.0
24716.23,805,778,27,44,253,0.0
24726.24,803,779,24,44,252,0.0
24736.25,806,780,26,45,252,0.0
24746.27,805,779,26,46,251,0.0
24756.22,806,779,27,44,252,0.0
24766.24,804,778,26,44,252,0.0
24776.25,803,778,25,45,253,0.0
24786.24,810,784,26,45,254,0.0
24796.23,804,779,25,45,252,0.0
24806.26,807,780,27,45,253,0.0
24816.23,804,779,25,45,252,0.0
24826.24,805,779,26,43,252,0.0
24836.23,805,780,25,45,252,0.0
24846.23,803,779,24,45,252,0.0
24856.22,808,779,29,45,252,0.0
24866.22,803,779,24,44,252,0.0
24876.25,805,780,25,44,252,0.0
24886.25,803,778,25,44,252,0.0
24896.24,803,780,23,43,252,0.0
24906.26,803,780,23,45,253,0.0
24916.23,805,779,26,44,252,0.0
24926.23,810,779,31,44,254,0.0
24936.22,804,780,24,43,253,0.0
24946.23,803,779,24,44,252,0.0
24956.25,803,780,23,44,252,0.0
24966.24,804,780,24,44,252,0.0
24976.25,805,780,25,44,253,0.0
24986.23,805,780,25,45,252,0.0
24996.24,803,779,24,44,252,0.0
25006.24,804,779,25,44,251,0.0
25016.25,808,773,35,44,251,0.0
25026.24,807,782,25,44,254,0.0
25036.24,801,779,22,44,253,0.0
25046.23,806,780,26,45,252,0.0
25056.23,805,780,25,45,252,0.0
25066.24,805,779,26,43,251,0.0
25076.25,804,779,25,45,252,0.0
25086.23,804,780,24,44,252,0.0
25096.24,805,780,25,43,252,0.0
25106.25,803,779,24,44,252,0.0
25116.26,805,781,24,45,252,0.0
25126.23,804,780,24,45,251,0.0
25136.23,805,780,25,44,252,0.0
25146.26,805,781,24,45,253,0.0
25156.27,805,779,26,46,252,0.0
25166.24,804,779,25,44,252,0.0
25176.24,804,779,25,45,252,0.0
25186.25,804,779,25,44,253,0.0
25196.23,809,783,26,44,254,0.0
25206.24,803,779,24,44,252,0.0
25216.26,804,781,23,44,253,0.0
25226.26,805,779,26,46,252,0.0
25236.24,806,780,26,44,252,0.0
25246.25,805,779,26,44,252,0.0
25256.25,803,780,23,44,252,0.0
25266.24,808,780,28,43,252,0.0
25276.24,803,779,24,43,252,0.0
25286.23,806,779,27,45,253,0.0
25296.25,804,778,26,45,252,0.0
25306.25,802,780,22,44,252,0.0
25316.26,804,780,24,46,252,-0.0333
25326.25,805,780,25,45,252,-0.0333
25336.24,804,780,24,45,252,0.0
25346.25,805,779,26,45,251,0.0
25356.23,802,779,23,44,252,0.0
25366.24,808,784,24,42,253,0.0
25376.23,799,778,21,45,251,0.0
25386.26,805,780,25,45,253,0.0
25396.23,805,779,26,46,252,0.0
25406.22,806,779,27,44,252,0.0
25416.24,806,777,29,44,252,0.0
25426.23,805,779,26,45,252,0.0
25436.25,808,784,24,43,253,0.0
25446.23,803,779,24,43,252,0.0
25456.23,804,780,24,44,252,0.0
25466.26,804,778,26,43,252,0.0
25476.23,804,779,25,44,252,0.0
25486.23,806,780,26,44,252,0.0
25496.25,804,780,24,45,252,0.0
25506.22,801,774,27,43,251,0.0
25516.23,804,779,25,45,252,0.0
25526.25,803,778,25,43,252,0.0
25536.23,805,780,25,45,252,0.0
25546.23,803,779,24,44,252,-0.0333
25556.25,807,781,26,46,253,0.0
25566.27,805,780,25,43,251,0.0
25576.23,804,780,24,44,252,0.0
25586.23,804,779,25,45,252,0.0
25596.25,803,779,24,45,252,0.0
25606.25,806,784,22,43,254,0.0
25616.22,804,779,25,43,252,0.0
25626.26,805,780,25,45,252,0.0
25636.27,804,779,25,44,252,0.0
25646.24,803,775,28,43,251,0.0
25656.23,806,779,27,45,252,0.0
25666.24,804,779,25,45,252,0.0
25676.24,804,779,25,45,252,0.0
25686.24,805,780,25,45,252,0.0
25696.25,805,780,25,44,252,0.0
25706.25,804,778,26,46,251,0.0
25716.23,803,780,23,44,252,0.0
25726.25,804,780,24,45,252,0.0
25736.23,802,784,18,45,252,0.0
25746.24,803,779,24,44,253,0.0
25756.23,804,780,24,45,252,0.0
25766.25,803,779,24,44,252,0.0
25776.25,808,785,23,46,253,0.0
25786.23,803,779,24,44,253,0.0
25796.26,803,779,24,45,252,0.0
25806.23,805,780,25,44,252,0.0
25816.24,804,779,25,45,252,0.0
25826.26,803,779,24,44,253,0.0
25836.23,804,780,24,44,252,0.0
25846.24,804,778,26,45,252,0.0333
25856.23,807,779,28,43,252,0.0
25866.25,804,780,24,44,253,0.0
25876.23,806,779,27,46,251,0.0
25886.24,805,780,25,44,252,0.0
25896.26,805,780,25,46,252,-0.0333
25906.27,804,780,24,44,252,0.0
25916.23,810,779,31,45,254,0.0
25926.23,804,779,25,45,252,0.0
25936.23,804,779,25,45,252,0.0
25946.24,808,784,24,44,253,0.0
25956.23,802,779,23,44,252,0.0
25966.25,805,781,24,44,252,0.0
25976.23,805,779,26,44,252,0.0
25986.23,805,779,26,45,252,0.0
25996.23,802,778,24,45,251,0.0
26006.24,807,773,34,43,251,0.0
26016.22,809,780,29,44,252,0.0
26026.25,803,780,23,43,253,-0.0333
26036.26,804,780,24,44,252,0.0
26046.26,804,778,26,45,251,-0.0333
26056.24,805,779,26,44,252,0.0
26066.25,805,780,25,45,252,0.0
26076.26,805,780,25,45,252,0.0
26086.23,805,779,26,44,253,0.0
26096.23,815,777,38,46,252,0.0
26106.24,803,780,23,45,252,0.0
26116.25,809,784,25,44,253,0.0
26126.23,804,779,25,44,253,0.0
26136.23,805,779,26,45,253,0.0
26146.27,805,779,26,46,252,0.0
26156.23,805,779,26,45,252,0.0
26166.23,805,780,25,45,252,0.0
26176.24,805,779,26,44,252,0.0
26186.23,810,780,30,44,253,0.0
26196.23,804,779,25,45,252,0.0
26206.26,805,779,26,44,252,0.0
26216.25,805,778,27,44,252,0.0
26226.23,804,780,24,45,252,0.0
26236.26,805,780,25,44,252,0.0
26246.23,807,780,27,45,252,0.0
26256.23,806,779,27,44,252,0.0
26266.23,805,779,26,44,252,0.0
26276.23,802,775,27,44,254,0.0
26286.24,809,785,24,45,254,0.0
26296.23,803,778,25,43,252,0.0
26306.23,806,780,26,46,253,0.0
26316.23,805,780,25,44,253,0.0
26326.24,805,781,24,45,252,0.0
26336.23,804,779,25,45,252,0.0
26346.25,803,779,24,45,252,0.0
26356.25,809,783,26,44,253,0.0
26366.24,797,779,18,42,249,0.0
26376.23,803,778,25,44,252,0.0
26386.27,804,777,27,45,252,0.0
26396.23,802,778,24,44,251,0.0
26406.23,804,780,24,45,252,0.0
26416.23,803,779,24,45,252,0.0
26426.23,803,778,25,43,252,0.0
26436.23,802,776,26,44,252,0.0
26446.26,802,778,24,44,252,0.0
26456.25,800,777,23,43,250,0.0
26466.24,803,778,25,44,252,0.0
26476.25,804,779,25,44,253,0.0
26486.23,803,779,24,45,252,0.0
26496.23,803,778,25,45,252,0.0
26506.23,804,778,26,44,252,0.0
26516.25,803,779,24,45,252,-0.0333
26526.24,808,783,25,44,253,0.0
26536.24,803,778,25,44,252,0.0
26546.26,806,773,33,44,252,0.0
26556.25,803,777,26,44,252,0.0
26566.23,804,778,26,44,253,0.0
26576.23,804,778,26,44,252,0.0
26586.23,802,778,24,43,253,0.0333
26596.24,805,779,26,44,251,0.0
26606.24,803,778,25,45,252,0.0
26616.23,805,779,26,44,252,0.0
26626.25,803,778,25,44,251,0.0
26636.23,807,778,29,44,251,0.0
26646.25,804,780,24,45,252,0.0
26656.27,803,780,23,44,252,0.0
26666.24,803,778,25,44,252,0.0
26676.23,804,777,27,44,252,0.0
26686.24,804,779,25,44,252,0.0
26696.24,808,783,25,44,254,0.0
26706.23,803,778,25,44,252,0.0
26716.25,804,780,24,45,252,0.0
26726.27,804,777,27,43,254,0.0
26736.23,804,778,26,44,252,0.0
26746.23,805,779,26,44,252,0.0
26756.23,804,779,25,45,252,0.0
26766.23,807,779,28,44,252,0.0
26776.24,804,779,25,44,252,0.0
26786.23,804,778,26,43,251,-0.0333
26796.25,804,778,26,44,252,0.0
26806.23,801,776,25,42,252,0.0
26816.25,803,784,19,44,250,0.0
26826.23,804,779,25,45,252,0.0
26836.24,803,778,25,44,252,0.0
26846.23,804,778,26,45,251,0.0
26856.24,803,779,24,45,252,0.0
26866.24,808,783,25,45,254,0.0
26876.24,803,777,26,44,252,0.0
26886.23,803,780,23,45,253,0.0
26896.26,806,777,29,45,252,0.0
26906.24,804,779,25,45,252,0.0
26916.23,804,778,26,45,252,0.0
26926.23,803,779,24,44,252,0.0333
26936.23,809,784,25,44,252,0.0
26946.24,802,778,24,43,252,0.0
26956.26,804,778,26,45,252,0.0
26966.26,804,778,26,44,251,0.0
26976.23,804,778,26,43,252,0.0
26986.26,804,780,24,44,253,0.0
26996.23,799,772,27,46,252,0.0
27006.23,802,778,24,44,252,-0.0333
27016.24,800,778,22,45,252,0.0
27026.23,804,778,26,44,252,0.0
27036.23,804,780,24,44,251,0.0
27046.24,803,778,25,45,252,0.0
27056.25,804,779,25,44,252,0.0
27066.26,804,779,25,44,252,0.0
27076.23,803,778,25,44,252,0.0
27086.23,804,780,24,44,252,0.0
27096.24,804,779,25,43,252,0.0
27106.24,809,783,26,44,254,0.0
27116.24,804,778,26,43,251,0.0
27126.25,805,780,25,45,252,0.0
27136.26,804,777,27,44,252,0.0
27146.23,804,780,24,44,252,0.0
27156.26,804,779,25,44,251,0.0
27166.24,803,778,25,44,252,0.0
27176.24,809,780,29,45,252,0.0
27186.24,804,779,25,44,252,0.0
27196.23,803,778,25,45,252,0.0
27206.23,804,777,27,45,251,0.0
27216.23,803,778,25,44,252,0.0333
27226.23,804,779,25,45,252,0.0
27236.27,804,780,24,45,252,0.0
27246.24,803,776,27,44,252,0.0
27256.25,805,778,27,44,252,0.0
27266.24,803,784,19,45,252,0.0
27276.26,808,783,25,44,254,0.0
27286.24,804,779,25,44,252,0.0
27296.25,805,778,27,46,252,0.0
27306.26,804,778,26,45,251,0.0
27316.23,804,778,26,45,252,0.0
27326.25,804,778,26,46,252,0.0
27336.25,804,779,25,43,252,0.0333
27346.23,806,779,27,44,252,0.0
27356.23,798,777,21,44,249,0.0
27366.26,803,779,24,44,253,0.0
27376.23,803,778,25,45,251,0.0
27386.24,804,779,25,44,252,0.0
27396.26,806,779,27,45,252,0.0
27406.23,805,779,26,45,252,0.0
27416.23,802,778,24,45,252,0.0
27426.23,803,777,26,43,251,0.0
27436.25,802,778,24,43,252,0.0
27446.23,813,783,30,45,254,0.0
27456.23,803,778,25,45,252,0.0
27466.23,805,779,26,45,252,0.0
27476.23,804,778,26,46,251,0.0
27486.24,805,779,26,43,253,0.0
27496.23,801,776,25,44,253,0.0
27506.24,803,777,26,44,252,0.0
27516.24,806,779,27,44,252,0.0
27526.24,803,779,24,45,252,0.0
27536.26,809,773,36,44,252,0.0
27546.26,803,779,24,44,251,0.0
27556.24,802,777,25,44,252,0.0
27566.23,804,778,26,44,253,0.0
27576.26,804,779,25,46,252,0.0
27586.24,803,779,24,44,252,0.0333
27596.23,804,778,26,46,251,0.0
27606.23,803,778,25,45,252,0.0
27616.25,809,783,26,45,253,0.0
27626.24,804,778,26,45,252,0.0
27636.23,804,780,24,44,253,0.0
27646.27,803,778,25,45,252,0.0
27656.23,803,779,24,44,252,0.0
27666.23,804,778,26,44,252,0.0
27676.23,802,778,24,45,252,0.0
27686.24,808,780,28,45,252,-0.0333
27696.24,803,779,24,44,252,0.0
27706.23,802,778,24,43,252,0.0
27716.26,808,782,26,44,250,0.0
27726.23,804,779,25,44,253,0.0
27736.23,802,776,26,44,251,-0.0333
27746.23,806,779,27,45,252,0.0
27756.22,803,779,24,44,252,0.0
27766.23,804,778,26,45,252,0.0
27776.23,803,779,24,44,252,0.0
27786.24,807,784,23,45,253,0.0
27796.23,801,778,23,44,252,0.0
27806.23,803,779,24,46,252,0.0
27816.27,805,777,28,45,251,0.0
27826.23,803,778,25,44,251,0.0
27836.23,804,777,27,45,252,0.0
27846.23,802,778,24,44,252,0.0
27856.24,804,780,24,44,252,0.0
27866.24,803,779,24,44,252,0.0
27876.25,803,778,25,45,252,0.0
27886.23,804,777,27,45,252,0.0
27896.24,803,779,24,45,251,0.0
27906.23,804,779,25,46,252,0.0
27916.22,805,779,26,45,252,0.0
27926.24,803,778,25,43,252,0.0
27936.23,802,778,24,44,251,0.0
27946.23,803,778,25,44,252,0.0
27956.23,805,780,25,44,252,0.0
27966.24,805,778,27,44,252,0.0
27976.26,804,779,25,46,252,0.0
27986.23,806,780,26,43,251,0.0
27996.24,802,778,24,44,252,0.0
28006.23,804,778,26,45,251,0.0
28016.23,803,778,25,44,252,0.0
28026.23,808,782,26,45,253,0.0
28036.24,803,778,25,45,252,0.0
28046.26,806,780,26,44,252,-0.0333
28056.23,804,777,27,44,252,0.0
28066.24,803,778,25,44,251,0.0
28076.26,799,778,21,44,252,0.0
28086.23,803,778,25,44,252,0.0
28096.23,808,779,29,44,252,0.0
28106.24,803,778,25,44,251,0.0
28116.23,804,778,26,44,252,0.0
28126.26,803,777,26,44,251,0.0
28136.24,804,779,25,44,252,0.0
28146.23,804,779,25,45,253,0.0
28156.27,804,778,26,43,252,0.0
28166.23,808,777,31,45,254,0.0
28176.23,803,778,25,43,252,0.0
28186.24,804,778,26,44,252,0.0
28196.23,809,784,25,44,254,0.0
28206.23,803,779,24,44,251,0.0
28216.26,803,779,24,45,252,0.0
28226.27,804,779,25,46,252,0.0
28236.25,804,779,25,44,252,0.0
28246.26,806,779,27,45,252,0.0
28256.24,803,783,20,44,252,0.0
28266.23,803,778,25,44,252,-0.0333
28276.24,801,776,25,44,252,0.0
28286.26,805,779,26,43,252,0.0
28296.23,804,780,24,45,252,0.0
28306.24,803,778,25,44,252,0.0
28316.23,803,779,24,44,253,0.0
28326.23,805,779,26,44,252,0.0
28336.23,803,778,25,44,252,0.0
28346.23,806,777,29,43,252,0.0
28356.23,802,778,24,45,252,0.0
28366.25,809,783,26,43,253,0.0
28376.23,803,778,25,44,252,0.0
28386.23,805,780,25,45,253,-0.0333
28396.26,804,778,26,44,251,0.0
28406.24,805,778,27,43,251,0.0
28416.25,804,778,26,45,251,0.0
28426.23,804,779,25,45,251,0.0
28436.25,811,780,31,43,253,0.0
28446.23,806,780,26,44,252,0.0
28456.25,806,779,27,44,252,0.0
28466.25,805,778,27,43,253,0.0
28476.22,803,779,24,44,253,0.0
28486.23,805,780,25,46,253,0.0
28496.27,803,780,23,44,252,0.0
28506.23,805,779,26,45,252,0.0
28516.23,804,779,25,43,252,0.0
28526.23,802,775,27,44,249,0.0
28536.25,809,785,24,44,255,0.0
28546.24,799,780,19,44,252,0.0
28556.23,804,780,24,44,253,0.0
28566.23,806,779,27,45,251,0.0
28576.25,803,778,25,44,252,0.0
28586.23,806,779,27,45,252,0.0
28596.25,803,780,23,45,253,0.0
28606.25,810,780,30,45,252,0.0
28616.24,799,778,21,45,251,0.0
28626.25,805,779,26,44,252,0.0
28636.26,804,778,26,44,252,0.0
28646.25,803,780,23,45,252,0.0
28656.26,803,777,26,44,252,-0.0333
28666.22,804,779,25,45,252,0.0
28676.23,803,779,24,44,252,0.0
28686.23,804,779,25,45,251,0.0
28696.25,804,779,25,44,252,0.0
28706.26,805,781,24,46,251,0.0
28716.23,804,778,26,44,252,0.0
28726.23,806,781,25,45,253,-0.0333
28736.23,806,780,26,45,253,0.0
28746.23,805,779,26,44,252,0.0
28756.23,805,779,26,45,252,0.0
28766.23,804,779,25,46,253,0.0
28776.24,809,785,24,45,254,0.0
28786.24,805,780,25,44,252,0.0
28796.25,799,780,19,45,255,0.0
28806.23,806,777,29,45,252,0.0
28816.24,803,778,25,44,252,0.0
28826.23,805,779,26,43,252,0.0
28836.23,804,780,24,44,252,0.0
28846.23,807,778,29,44,252,0.0
28856.23,804,780,24,44,252,0.0
28866.23,805,780,25,46,252,0.0
28876.23,805,778,27,44,252,0.0
28886.22,811,779,32,44,252,0.0333
28896.23,807,780,27,45,252,0.0
28906.25,806,780,26,45,252,0.0
28916.24,805,779,26,44,252,0.0
28926.23,805,779,26,44,252,0.0
28936.23,805,780,25,44,252,0.0
28946.25,812,784,28,45,254,0.0
28956.23,805,778,27,45,252,0.0
28966.23,806,781,25,44,253,-0.0333
28976.26,807,779,28,45,252,0.0
28986.24,806,780,26,44,252,0.0
28996.25,807,779,28,45,252,0.0
29006.25,805,780,25,43,252,0.0
29016.24,810,780,30,45,252,0.0
29026.24,803,780,23,44,253,0.0
29036.25,805,779,26,44,252,-0.0333
29046.23,807,778,29,45,252,0.0
29056.23,805,779,26,45,252,0.0
29066.25,803,787,16,44,251,0.0
29076.26,805,780,25,46,253,0.0
29086.23,803,780,23,43,252,0.0
29096.23,807,779,28,44,252,0.0
29106.24,806,780,26,43,252,0.0
29116.23,809,785,24,44,253,-0.0333
29126.24,804,778,26,45,252,0.0
29136.25,805,780,25,45,252,0.0
29146.26,806,779,27,44,252,0.0
29156.22,805,780,25,43,253,0.0
29166.26,805,780,25,44,252,0.0
29176.24,805,779,26,44,252,0.0
29186.23,810,783,27,44,252,0.0
29196.23,803,779,24,45,252,0.0
29206.26,805,779,26,44,252,0.0
29216.26,805,778,27,44,251,0.0
29226.23,804,779,25,44,251,0.0
29236.25,806,780,26,44,253,0.0
29246.23,804,775,29,45,252,0.0
29256.25,805,778,27,44,253,0.0
29266.23,806,780,26,44,252,0.0
29276.23,804,779,25,44,252,-0.0333
29286.24,810,784,26,45,254,0.0
29296.22,804,779,25,43,252,0.0
29306.25,806,779,27,45,253,0.0
29316.23,804,778,26,45,253,0.0
29326.23,803,777,26,44,251,0.0
29336.23,806,780,26,45,252,0.0
29346.25,805,780,25,44,252,0.0
29356.24,809,781,28,44,253,0.0
29366.22,804,778,26,46,252,0.0
29376.26,805,780,25,43,252,0.0
29386.23,805,778,27,45,252,-0.0333
29396.24,805,779,26,44,252,0.0
29406.26,806,780,26,44,252,0.0
29416.23,805,779,26,45,252,0.0
29426.23,801,779,22,43,250,0.0
29436.22,804,779,25,44,252,0.0
29446.25,805,780,25,43,253,0.0
29456.26,809,784,25,44,254,0.0
29466.24,804,779,25,43,253,0.0
29476.23,806,780,26,45,253,0.0
29486.23,804,781,23,45,252,0.0
29496.23,802,778,24,43,253,0.0
29506.26,805,778,27,45,252,0.0
29516.24,804,773,31,43,251,0.0
29526.23,810,784,26,44,254,0.0
29536.24,804,780,24,44,252,0.0
29546.23,805,780,25,44,253,0.0
29556.23,804,777,27,45,251,0.0
29566.23,805,779,26,44,251,0.0
29576.26,804,779,25,45,252,0.0
29586.25,803,779,24,43,253,0.0
29596.24,809,780,29,44,252,-0.0333
29606.23,799,780,19,43,251,0.0
29616.25,806,780,26,45,252,0.0
29626.23,805,778,27,44,251,0.0
29636.23,805,780,25,44,252,0.0
29646.23,807,779,28,45,252,0.0
29656.27,806,780,26,45,252,0.0
29666.23,803,778,25,44,250,0.0333
29676.23,803,779,24,43,252,0.0
29686.23,804,778,26,44,252,0.0
29696.25,809,784,25,45,253,0.0
29706.24,803,778,25,44,252,0.0
29716.24,805,780,25,44,252,0.0
29726.23,804,778,26,45,252,0.0
29736.23,805,779,26,45,252,0.0
29746.25,804,777,27,45,251,0.0333
29756.23,804,778,26,45,252,0.0
29766.24,805,779,26,45,252,0.0
29776.24,803,779,24,44,252,0.0
29786.23,811,773,38,44,254,0.0
29796.23,804,777,27,44,251,-0.0333
29806.24,804,778,26,45,252,0.0
29816.23,805,778,27,45,253,0.0
29826.23,804,779,25,44,253,0.0
29836.23,803,779,24,43,251,0.0
29846.23,803,777,26,44,251,0.0
29856.23,803,779,24,44,252,0.0
29866.24,809,783,26,44,253,-0.0333
29876.23,804,778,26,45,252,0.0
29886.25,805,779,26,45,252,0.0
29896.23,804,778,26,43,251,0.0
29906.23,806,779,27,44,252,0.0
29916.23,804,778,26,44,252,0.0
29926.25,803,778,25,44,252,0.0
29936.23,809,779,30,44,252,0.0
29946.24,803,778,25,45,251,0.0
29956.24,805,778,27,45,252,0.0
29966.23,804,778,26,45,251,0.0
29976.24,804,778,26,44,252,0.0
29986.23,805,779,26,45,253,0.0
29996.26,804,780,24,45,252,0.0
30006.24,803,779,24,44,252,0.0
30016.24,804,778,26,45,251,0.0
30026.24,804,779,25,44,252,0.0
30036.23,809,784,25,43,254,0.0
30046.23,802,778,24,43,252,0.0
30056.25,800,780,20,45,253,0.0
30066.27,806,777,29,44,252,0.0
30076.23,805,778,27,43,252,-0.0333
30086.23,804,778,26,44,252,0.0
30096.24,805,779,26,45,253,0.0
30106.23,808,780,28,45,252,0.0
30116.24,803,778,25,44,252,0.0
30126.26,804,779,25,44,252,0.0
30136.23,804,777,27,44,252,0.0
30146.23,797,778,19,42,250,0.0
30156.23,804,779,25,45,252,0.0
30166.23,804,779,25,45,252,0.0
30176.25,803,777,26,44,252,0.0
30186.23,804,777,27,45,252,0.0
30196.24,804,778,26,46,252,0.0
30206.23,809,783,26,44,254,0.0
30216.24,803,778,25,43,252,0.0
30226.26,806,779,27,45,252,0.0
30236.23,804,773,31,46,252,0.0
30246.23,805,779,26,44,252,0.0
30256.25,804,778,26,45,252,0.0
30266.23,804,778,26,45,252,0.0
30276.22,808,779,29,44,252,0.0
30286.24,804,778,26,45,252,0.0
30296.23,806,778,28,44,253,0.0
30306.23,804,778,26,44,251,0.0
30316.24,803,779,24,43,252,0.0
30326.23,804,777,27,44,252,0.0
30336.26,805,779,26,44,252,0.0
30346.23,805,778,27,45,252,0.0
30356.23,803,778,25,44,253,0.0
30366.25,805,778,27,44,251,0.0
30376.23,804,778,26,46,251,0.0
30386.24,804,779,25,44,252,0.0
30396.23,805,779,26,46,252,0.0
30406.23,805,779,26,46,252,0.0
30416.23,797,780,17,43,250,0.0
30426.24,804,778,26,45,252,0.0
30436.24,803,779,24,44,252,0.0
30446.26,804,780,24,45,254,0.0
30456.23,804,778,26,43,252,0.0
30466.23,805,779,26,45,252,0.0
30476.27,804,778,26,45,252,0.0
30486.23,805,778,27,43,251,0.0
30496.23,804,778,26,44,252,0.0
30506.23,797,778,19,44,251,0.0
30516.24,808,781,27,43,252,-0.0333
30526.23,804,778,26,44,252,0.0
30536.26,805,778,27,45,252,0.0
30546.26,804,777,27,44,251,0.0
30556.24,803,778,25,45,252,0.0
30566.23,805,779,26,44,252,0.0
30576.23,804,779,25,45,252,0.0
30586.24,803,779,24,44,252,0.0
30596.25,798,779,19,44,251,-0.0333
30606.24,803,778,25,45,251,0.0
30616.24,808,783,25,44,253,-0.0333
30626.23,803,778,25,43,252,0.0
30636.25,804,779,25,45,252,0.0
30646.23,805,778,27,45,251,0.0
30656.23,806,779,27,44,251,0.0
30666.23,804,779,25,43,252,0.0
30676.25,804,777,27,44,252,0.0
30686.25,803,780,23,43,250,0.0
30696.23,803,778,25,45,252,0.0
30706.23,805,779,26,44,253,0.0
30716.23,803,778,25,44,251,0.0
30726.23,804,778,26,44,252,0.0
30736.27,805,779,26,43,253,0.0
30746.25,805,778,27,45,252,0.0
30756.23,804,778,26,44,252,0.0
30766.24,803,779,24,43,252,0.0
30776.23,799,779,20,44,252,0.0
30786.23,806,778,28,44,252,0.0
30796.24,806,778,28,45,252,0.0
30806.23,804,779,25,43,252,0.0
30816.23,806,778,28,44,252,0.0
30826.25,803,776,27,44,251,0.0
30836.24,804,779,25,44,252,0.0
30846.25,804,779,25,44,252,0.0
30856.26,804,780,24,44,252,0.0
30866.24,803,778,25,45,251,0.0
30876.25,804,779,25,45,251,0.0
30886.24,803,778,25,44,253,0.0
30896.23,807,783,24,44,254,0.0
30906.23,803,778,25,44,253,0.0
30916.23,805,780,25,44,253,0.0
30926.27,804,778,26,45,252,0.0
30936.23,805,779,26,43,252,0.0
30946.23,804,778,26,45,252,0.0
30956.23,807,776,31,44,254,0.0
30966.23,807,779,28,45,251,0.0
30976.25,804,779,25,44,252,0.0
30986.24,805,778,27,45,252,0.0
30996.26,804,778,26,45,251,0.0
31006.23,804,779,25,45,252,0.0
31016.26,806,780,26,43,252,0.0
31026.27,804,779,25,45,254,0.0
31036.23,804,779,25,44,252,0.0
31046.24,800,783,17,44,252,0.0
31056.23,803,778,25,44,252,0.0
31066.25,809,783,26,44,254,0.0
31076.23,802,778,24,44,252,0.0
31086.23,804,778,26,45,252,0.0
31096.23,804,779,25,44,252,0.0
31106.23,803,779,24,44,252,0.0
31116.23,805,778,27,44,251,0.0
31126.24,804,778,26,44,252,0.0
31136.22,815,779,36,43,252,0.0
31146.24,805,780,25,44,252,0.0
31156.23,804,778,26,45,252,0.0
31166.26,803,778,25,43,251,0.0
31176.22,804,778,26,44,252,0.0
31186.25,805,780,25,45,252,0.0
31196.26,805,779,26,45,252,0.0
31206.24,804,778,26,44,252,0.0
31216.24,804,779,25,45,252,0.0
31226.24,803,780,23,45,252,0.0
31236.22,809,784,25,45,254,0.0
31246.23,801,778,23,44,252,0.0
31256.23,804,780,24,46,252,0.0
31266.27,805,778,27,44,252,0.0
31276.24,803,779,24,44,252,0.0
31286.27,804,778,26,45,251,0.0
31296.23,804,779,25,44,252,0.0
31306.23,809,779,30,45,253,0.0
31316.24,805,779,26,44,252,0.0
31326.23,804,779,25,45,252,0.0
31336.25,802,775,27,44,251,0.0
31346.24,803,777,26,45,252,0.0
31356.23,804,779,25,44,253,0.0
31366.27,805,780,25,45,252,0.0
31376.23,803,778,25,44,252,0.0
31386.24,804,778,26,45,252,0.0
31396.23,803,779,24,43,252,0.0
31406.23,808,783,25,43,255,0.0
31416.23,803,778,25,44,252,0.0
31426.23,805,779,26,46,252,0.0
31436.23,805,778,27,44,252,0.0
31446.23,803,778,25,45,252,0.0333
31456.26,803,778,25,44,252,0.0
31466.24,804,778,26,44,252,0.0
31476.24,808,782,26,44,252,0.0
31486.23,804,778,26,43,252,0.0
31496.23,806,773,33,44,250,0.0
31506.24,800,775,25,44,251,0.0
31516.24,804,778,26,45,252,0.0
31526.23,805,779,26,45,252,0.0
31536.25,804,780,24,45,252,0.0
31546.24,802,778,24,44,252,0.0
31556.23,803,779,24,44,252,0.0
31566.23,805,779,26,44,252,0.0
31576.23,805,778,27,44,252,0.0
31586.23,799,778,21,44,250,0.0
31596.26,804,777,27,45,252,0.0
31606.27,804,780,24,45,252,0.0
31616.23,803,778,25,44,252,0.0
31626.23,805,779,26,45,251,0.0
31636.23,804,778,26,44,252,0.0
31646.25,808,784,24,45,253,0.0
31656.23,804,779,25,44,252,0.0
31666.25,806,780,26,45,253,0.0
31676.26,804,775,29,45,253,0.0
31686.24,803,779,24,44,252,0.0
31696.25,805,777,28,45,252,0.0
31706.24,804,779,25,44,252,0.0
31716.24,808,779,29,44,252,0.0
31726.23,803,779,24,45,252,0.0
31736.23,805,780,25,44,252,0.0
31746.26,806,778,28,43,253,0.0
31756.23,805,780,25,44,252,0.0
31766.23,808,778,30,45,254,0.0
31776.24,806,780,26,45,253,0.0
31786.23,805,780,25,45,252,0.0
31796.23,805,779,26,45,252,0.0
31806.24,806,780,26,45,252,0.0
31816.23,809,784,25,45,254,0.0
31826.23,804,779,25,44,253,0.0
31836.25,807,780,27,45,253,0.0
31846.26,805,779,26,45,252,0.0
31856.25,804,780,24,45,252,0.0
31866.23,805,779,26,44,252,0.0
31876.25,804,779,25,44,252,-0.0333
31886.25,808,780,28,44,253,0.0
31896.24,805,780,25,44,252,0.0
31906.23,805,779,26,44,252,0.0
31916.27,806,778,28,44,252,0.0
31926.24,803,779,24,44,253,0.0
31936.23,803,780,23,46,253,-0.0333
31946.25,800,780,20,45,253,0.0
31956.23,804,779,25,44,252,0.0
31966.24,805,780,25,45,252,0.0
31976.23,805,779,26,44,253,-0.0333
31986.23,810,785,25,45,254,0.0
31996.23,805,780,25,44,252,0.0
32006.23,806,780,26,45,253,0.0
32016.23,805,779,26,44,252,0.0
32026.23,805,780,25,43,252,0.0
32036.23,801,779,22,46,252,0.0
32046.23,804,780,24,44,253,0.0
32056.23,809,781,28,43,253,0.0
32066.24,804,780,24,45,252,0.0
32076.23,807,780,27,45,252,0.0
32086.26,804,778,26,45,252,0.0
32096.24,804,779,25,44,253,0.0
32106.23,805,779,26,45,253,0.0
32116.23,806,779,27,44,251,0.0
32126.23,803,778,25,44,251,0.0
32136.23,803,780,23,44,252,0.0
32146.23,804,780,24,44,253,0.0
32156.23,807,781,26,44,252,0.0
32166.23,804,779,25,43,252,0.0333
32176.23,806,780,26,44,253,0.0
32186.26,805,781,24,44,252,0.0
32196.23,803,779,24,44,253,0.0
32206.23,806,780,26,44,253,0.0
32216.25,805,781,24,45,253,0.0
32226.24,807,785,22,44,253,0.0
32236.23,803,780,23,44,253,0.0
32246.23,807,780,27,45,253,0.0
32256.27,805,779,26,44,252,0.0
32266.23,805,779,26,43,253,0.0
32276.23,806,780,26,45,252,0.0
32286.23,805,779,26,44,252,0.0
32296.23,805,780,25,45,253,0.0
32306.24,805,779,26,45,251,-0.0333
32316.25,805,778,27,44,252,0.0
32326.23,805,779,26,45,252,0.0
32336.23,806,780,26,43,252,0.0
32346.25,806,779,27,45,252,0.0
32356.26,805,781,24,45,253,0.0
32366.23,803,779,24,44,251,0.0
32376.23,804,778,26,44,252,0.0
32386.25,805,780,25,43,252,0.0
32396.24,809,785,24,45,254,0.0
32406.23,804,779,25,43,252,0.0
32416.25,807,780,27,45,252,-0.0333
32426.26,805,779,26,45,252,0.0
32436.23,806,780,26,45,252,0.0333
32446.23,806,779,27,44,253,0.0
32456.24,806,780,26,44,252,0.0
32466.23,809,781,28,45,252,0.0
32476.23,803,779,24,44,253,0.0
32486.23,807,779,28,44,253,0.0
32496.23,805,779,26,44,251,0.0333
32506.23,804,779,25,44,252,0.0
32516.23,805,780,25,44,252,0.0
32526.24,805,779,26,45,253,0.0
32536.23,804,780,24,43,253,0.0
32546.24,805,779,26,44,251,0.0
32556.24,804,779,25,45,252,0.0
32566.23,810,784,26,45,254,0.0
32576.23,806,778,28,44,253,0.0
32586.25,804,780,24,44,253,0.0
32596.23,805,780,25,44,252,0.0
32606.23,804,779,25,43,251,0.0
32616.23,806,780,26,45,253,0.0
32626.24,803,780,23,44,252,0.0
32636.23,804,779,25,43,252,0.0
32646.24,805,780,25,44,252,0.0
32656.23,806,779,27,44,252,0.0
32666.26,806,779,27,45,253,0.0
32676.23,805,779,26,44,253,0.0
32686.26,803,780,23,45,253,0.0
32696.26,805,781,24,45,252,0.0
32706.23,805,779,26,45,253,-0.0333
32716.23,805,780,25,43,252,0.0
32726.23,805,779,26,44,252,0.0
32736.23,810,785,25,44,253,0.0
32746.24,804,779,25,44,253,0.0
32756.23,811,782,29,45,253,0.0
32766.23,806,779,27,45,252,0.0
32776.23,805,780,25,44,252,0.0
32786.25,805,778,27,44,252,0.0
32796.23,804,779,25,44,253,0.0
32806.23,806,780,26,44,252,0.0
32816.23,804,779,25,44,252,0.0
32826.26,805,779,26,44,252,0.0
32836.23,805,778,27,44,252,-0.0333
32846.24,804,784,20,45,252,0.0
32856.26,804,779,25,44,252,0.0
32866.25,804,777,27,45,253,0.0
32876.23,803,777,26,45,252,0.0
32886.23,804,780,24,43,252,0.0
32896.24,805,780,25,44,252,0.0
32906.25,803,780,23,44,252,0.0
32916.23,804,779,25,43,252,0.0
32926.25,805,780,25,46,252,0.0
32936.23,807,780,27,46,252,0.0
32946.24,804,778,26,44,253,0.0
32956.24,805,779,26,45,252,0.0
32966.25,805,780,25,43,252,0.0
32976.25,809,784,25,44,254,0.0
32986.23,804,779,25,44,253,-0.0333
32996.26,806,780,26,44,252,0.0
33006.23,806,779,27,45,251,0.0
33016.23,800,774,26,45,251,0.0
33026.24,800,776,24,43,249,0.0
33036.25,799,777,22,44,251,0.0
33046.23,801,773,28,45,250,0.0
33056.24,800,774,26,45,251,0.0
33066.26,803,776,27,45,252,0.0
33076.23,804,779,25,44,251,0.0
33086.24,800,776,24,44,251,0.0
33099.9,805,779,26,44,252,0.0
33106.23,805,777,28,45,251,0.0333
33116.25,803,773,30,43,250,0.0
33126.4,800,775,25,43,252,0.0
33136.27,802,776,26,45,251,0.0
33146.24,801,774,27,43,251,0.0
33156.25,807,781,26,45,253,0.0
33166.25,807,781,26,44,253,0.0
33176.23,803,774,29,44,251,0.0
33186.25,802,776,26,43,251,0.0
33196.26,804,779,25,45,252,0.0
33206.26,806,777,29,45,253,0.0
33216.23,804,777,27,43,251,0.0
33226.24,806,779,27,45,253,0.0
33236.23,803,780,23,44,252,0.0
33246.23,806,780,26,44,252,0.0
33256.47,799,775,24,43,251,0.0
33266.26,805,780,25,44,252,0.0
33276.24,804,776,28,43,249,0.0
33286.24,806,780,26,44,252,0.0
33296.23,801,784,17,44,251,0.0
33306.27,804,780,24,44,252,0.0
33316.23,804,778,26,43,252,0.0
33326.23,805,780,25,44,253,0.0
33336.23,806,779,27,44,252,0.0
33346.24,804,779,25,43,252,0.0
33356.22,805,780,25,44,251,0.0
33366.23,806,778,28,44,252,0.0
33376.23,803,778,25,44,252,0.0
33386.24,803,783,20,44,253,0.0
33396.26,804,780,24,44,253,0.0
33406.23,805,780,25,45,252,0.0
33416.23,806,780,26,44,252,0.0
33426.25,805,779,26,45,252,0.0
33436.23,804,779,25,44,252,0.0
33446.25,809,785,24,45,254,0.0
33456.22,804,779,25,44,251,0.0
33466.25,805,780,25,45,253,0.0
33476.23,800,780,20,44,251,0.0
33486.23,806,779,27,43,252,0.0
33496.23,805,779,26,44,251,0.0
33506.22,804,780,24,44,253,0.0
33516.23,809,780,29,44,252,0.0
33526.23,803,778,25,44,252,0.0
33536.26,805,779,26,46,252,0.0
33546.26,805,779,26,44,252,0.0
33556.25,804,779,25,43,252,0.0
33566.26,803,786,17,44,253,0.0
33576.23,805,779,26,45,252,-0.0333
33586.24,804,780,24,44,252,0.0
33596.25,804,780,24,45,252,0.0
33606.25,804,780,24,45,252,0.0
33616.23,810,784,26,45,254,0.0
33626.24,804,778,26,43,252,0.0
33636.23,806,780,26,45,253,0.0
33646.26,805,779,26,45,252,0.0
33656.24,805,779,26,45,251,0.0
33666.23,805,779,26,43,252,0.0
33676.23,804,779,25,45,252,0.0
33686.23,808,780,28,44,252,-0.0333
33696.24,805,780,25,44,253,0.0
33706.25,805,779,26,45,252,0.0
33716.25,805,778,27,45,252,0.0
33726.24,804,778,26,45,253,0.0333
33736.25,807,781,26,46,251,0.0
33746.27,802,775,27,44,252,0.0
33756.24,804,779,25,43,253,0.0
33766.23,806,779,27,46,253,0.0
33776.25,805,778,27,45,252,0.0
33786.23,811,784,27,44,254,0.0
33796.24,805,779,26,44,252,0.0
33806.25,806,780,26,45,253,0.0
33816.23,806,779,27,45,252,0.0
33826.23,805,780,25,45,252,0.0
33836.25,805,779,26,44,254,0.0
33846.23,804,779,25,44,253,0.0
33856.24,807,781,26,44,253,0.0
33866.25,804,779,25,43,252,0.0
33876.23,805,780,25,44,251,0.0
33886.25,804,778,26,43,252,0.0
33896.24,804,779,25,45,252,0.0
33906.23,804,780,24,43,252,0.0
33916.25,806,779,27,45,252,0.0
33926.23,806,784,22,45,252,0.0
33936.25,805,779,26,44,253,0.0
33946.23,804,779,25,44,252,0.0
33956.27,809,784,25,45,254,0.0
33966.25,805,779,26,44,252,0.0
33976.23,803,781,22,45,252,0.0
33986.27,803,780,23,44,252,0.0333
33996.23,806,779,27,45,252,0.0
34006.25,805,779,26,45,252,0.0
34016.23,806,780,26,45,253,0.0
34026.25,806,780,26,45,253,0.0
34036.25,804,779,25,43,253,0.0
34046.25,806,779,27,44,252,0.0
34056.23,804,777,27,44,251,0.0
34066.23,804,779,25,44,253,0.0
34076.26,805,780,25,45,252,0.0
34086.23,805,780,25,46,251,0.0
34096.24,804,779,25,44,252,0.0
34106.25,807,783,24,44,252,0.0
34116.24,805,780,25,44,252,0.0
34126.23,803,780,23,42,252,0.0
34136.25,804,778,26,45,252,0.0
34146.23,806,780,26,43,253,0.0
34156.23,806,780,26,44,253,0.0
34166.23,805,779,26,44,252,0.0
34176.23,804,779,25,45,252,0.0
34186.23,806,780,26,45,251,0.0
34196.24,807,780,27,45,252,0.0
34206.25,804,779,25,44,252,0.0
34216.23,806,780,26,44,252,0.0
34226.26,805,779,26,45,252,0.0
34236.25,806,779,27,45,252,0.0
34246.25,804,780,24,45,253,0.0
34256.23,803,779,24,44,252,0.0
34266.23,804,779,25,44,252,0.0
34276.23,805,779,26,45,252,0.0
34286.25,803,780,23,45,251,0.0
34296.24,809,784,25,44,253,0.0333
34306.23,803,779,24,45,252,0.0
34316.23,805,780,25,45,252,0.0
34326.27,805,779,26,45,252,0.0
34336.24,807,780,27,44,252,0.0
34346.25,806,779,27,45,252,0.0
34356.25,803,776,27,45,251,0.0
34366.25,809,782,27,44,252,0.0
34376.23,803,784,19,45,252,0.0
34386.23,805,780,25,44,252,0.0
34396.23,804,779,25,44,252,-0.0333
34406.23,803,779,24,43,252,0.0
34416.25,806,780,26,44,252,0.0
34426.24,805,780,25,45,252,-0.0333
34436.23,804,779,25,44,252,0.0
34446.24,805,779,26,44,252,0.0
34456.25,804,779,25,45,252,0.0
34466.26,802,781,21,44,251,0.0
34476.24,804,779,25,46,253,0.0
34486.25,804,780,24,45,252,0.0
34496.26,805,779,26,45,252,0.0
34506.23,805,779,26,45,252,0.0
34516.25,806,778,28,44,252,0.0
34526.25,805,779,26,45,252,0.0
34536.23,810,784,26,45,254,0.0
34546.23,805,779,26,44,251,0.0
34556.26,801,781,20,46,253,0.0
34566.27,807,779,28,45,252,0.0
34576.23,805,779,26,44,253,0.0
34586.25,805,778,27,45,252,0.0
34596.23,805,780,25,44,253,0.0
34606.24,806,780,26,44,252,0.0
34616.24,804,779,25,44,253,0.0
34626.25,806,780,26,44,253,0.0
34636.25,803,777,26,43,251,0.0
34646.25,803,773,30,42,251,0.0
34656.23,806,779,27,45,252,0.0
34666.25,805,780,25,45,252,0.0
34676.23,803,779,24,44,252,0.0
34686.24,803,778,25,44,252,0.0
34696.26,804,779,25,45,252,0.0
34706.23,807,781,26,43,252,0.0
34716.23,804,779,25,44,252,0.0
34726.26,805,780,25,46,252,0.0
34736.23,800,775,25,44,252,0.0
34746.23,805,779,26,45,252,0.0
34756.23,805,779,26,44,252,0.0
34766.23,806,779,27,44,252,0.0
34776.24,808,784,24,45,253,0.0
34786.23,805,780,25,43,252,0.0
34796.23,806,780,26,45,252,0.0
34806.27,805,780,25,43,252,0.0
34816.23,805,780,25,43,252,0.0
34826.25,801,776,25,45,251,0.0
34836.25,802,777,25,43,250,0.0
34846.23,805,779,26,44,252,-0.0333
34856.25,805,780,25,44,253,0.0
34866.25,805,779,26,44,252,0.0
34876.25,804,779,25,44,252,0.0
34886.23,806,779,27,43,252,0.0
34896.23,802,779,23,45,251,0.0
34906.23,804,779,25,44,252,0.0
34916.24,803,776,27,44,255,0.0
34926.24,805,780,25,44,251,0.0
34936.23,806,780,26,44,253,0.0
34946.23,809,785,24,44,254,0.0
34956.24,804,778,26,45,252,0.0
34966.26,806,780,26,45,252,0.0
34976.27,804,779,25,45,252,0.0
34986.24,804,781,23,43,253,0.0
34996.26,804,779,25,44,252,0.0
35006.23,799,780,19,44,252,0.0
35016.23,808,780,28,43,252,0.0
35026.23,804,779,25,44,252,0.0
35036.23,804,780,24,45,253,0.0
35046.25,805,779,26,45,251,0.0
35056.24,804,779,25,44,252,0.0
35066.23,805,780,25,44,252,0.0
35076.23,805,781,24,45,252,0.0
35086.23,803,779,24,44,252,0.0
35096.23,804,777,27,45,252,0.0
35106.23,805,779,26,44,253,0.0
35116.23,802,779,23,44,252,-0.0333
35126.24,804,777,27,45,252,0.0
35136.23,804,779,25,45,252,0.0
35146.27,806,778,28,45,252,0.0
35156.23,805,778,27,44,252,0.0
35166.25,805,779,26,45,252,0.0
35176.23,804,779,25,44,253,0.0
35186.23,807,781,26,44,251,0.0
35196.24,802,778,24,44,252,0.0
35206.23,804,779,25,43,252,0.0
35216.25,804,778,26,45,252,0.0
35226.24,804,778,26,45,252,0.0
35236.26,807,780,27,44,252,0.0
35246.23,805,780,25,45,253,0.0
35256.23,806,779,27,44,253,0.0
35266.23,805,779,26,44,252,0.0
35276.23,803,780,23,44,254,0.0
35286.23,810,784,26,45,254,0.0
35296.23,804,780,24,44,252,0.0
35306.26,805,780,25,44,253,0.0
35316.23,805,779,26,45,253,0.0
35326.24,805,779,26,45,253,0.0
35336.23,805,779,26,45,253,0.0
35346.23,806,779,27,44,252,0.0
35356.23,809,780,29,44,252,0.0
35366.23,803,776,27,44,254,0.0
35376.25,804,779,25,44,252,0.0
35386.26,805,777,28,43,251,0.0
35396.23,803,779,24,44,253,0.0
35406.23,805,780,25,44,252,0.0
35416.24,804,781,23,44,253,0.0
35426.23,804,779,25,43,252,0.0
35436.23,800,776,24,45,252,0.0
35446.23,804,779,25,43,252,0.0
35456.23,799,781,18,43,251,0.0
35466.24,804,779,25,45,252,0.0
35476.23,806,780,26,44,252,0.0
35486.23,806,780,26,44,252,0.0
35496.24,805,779,26,45,252,0.0
35506.25,805,779,26,44,252,0.0
35516.23,805,779,26,45,252,0.0
35526.23,809,784,25,44,254,0.0
35536.23,804,780,24,43,252,0.0
35546.23,801,783,18,44,252,0.0
35556.23,804,779,25,45,252,0.0
35566.24,804,779,25,43,252,0.0
35576.23,805,778,27,43,252,0.0
35586.23,807,779,28,45,252,0.0
35596.23,805,780,25,44,252,0.0
35606.23,805,779,26,44,252,0.0
35616.25,805,779,26,45,252,0.0
35626.25,805,778,27,44,252,0.0
35636.24,804,783,21,44,253,0.0
35646.26,806,778,28,45,252,0.0
35656.26,805,779,26,44,252,0.0
35666.23,803,777,26,44,252,0.0
35676.24,804,780,24,44,252,0.0
35686.24,805,780,25,44,253,0.0
35696.23,808,784,24,44,253,0.0
35706.24,804,778,26,45,252,0.0
35716.23,807,780,27,45,252,0.0
35726.27,805,780,25,44,252,-0.0333
35736.23,806,780,26,43,253,0.0
35746.26,804,779,25,43,252,0.0
35756.24,804,779,25,44,253,0.0
35766.24,809,780,29,44,252,0.0
35776.24,804,780,24,43,253,0.0
35786.23,807,780,27,44,252,0.0
35796.26,803,779,24,44,252,0.0
35806.24,804,780,24,44,252,0.0
35816.25,799,784,15,44,253,0.0
35826.27,805,780,25,44,252,0.0
35836.23,804,780,24,44,253,0.0
35846.23,805,779,26,44,253,0.0
35856.24,806,779,27,44,252,0.0
35866.24,809,784,25,46,253,0.0
35876.24,804,779,25,43,252,0.0
35886.23,804,780,24,45,252,0.0
35896.25,805,777,28,44,252,0.0
35906.23,804,779,25,45,252,0.0
35916.26,805,779,26,44,252,0.0
35926.24,804,779,25,44,252,0.0
35936.22,809,780,29,44,253,0.0
35946.23,804,780,24,44,252,0.0
35956.25,806,779,27,45,252,0.0
35966.25,805,778,27,44,252,0.0333
35976.25,804,779,25,43,252,0.0
35986.26,805,779,26,45,253,0.0
35996.23,800,778,22,45,252,0.0
36006.23,804,779,25,43,252,0.0
36016.24,805,779,26,44,252,0.0
36026.23,804,779,25,44,251,0.0
36036.23,808,784,24,44,254,0.0
36046.23,803,779,24,45,252,0.0
36056.25,803,779,24,45,253,0.0
36066.23,805,779,26,44,252,0.0
36076.24,805,779,26,44,252,0.0
36086.23,805,778,27,44,252,0.0
36096.23,805,779,26,45,252,0.0
36106.24,808,780,28,43,252,0.0
36116.24,804,779,25,44,253,0.0
36126.25,806,781,25,46,252,0.0
36136.25,804,777,27,45,252,0.0
36146.23,804,779,25,44,252,-0.0333
36156.24,805,780,25,44,253,0.0
36166.26,804,779,25,45,252,0.0
36176.23,803,779,24,45,253,0.0
36186.23,804,779,25,45,252,0.0
36196.25,804,779,25,43,252,0.0
36206.23,808,784,24,44,254,0.0
36216.24,805,779,26,43,252,0.0
36226.25,806,779,27,44,253,0.0
36236.23,804,779,25,45,253,0.0
36246.24,805,779,26,44,252,0.0
36256.23,805,779,26,44,252,0.0
36266.24,805,776,29,45,254,0.0333
36276.23,809,780,29,43,252,0.0
36286.23,803,780,23,44,253,0.0
36296.25,805,780,25,45,252,0.0
36306.23,805,778,27,44,252,0.0
36316.25,804,780,24,44,252,0.0
36326.23,805,781,24,45,253,0.0
36336.27,805,780,25,45,252,0.0
36346.23,803,778,25,46,252,0.0
36356.23,800,781,19,45,252,0.0
36366.25,803,779,24,44,253,0.0
36376.23,808,784,24,44,254,0.0
36386.23,804,779,25,44,252,0.0
36396.25,804,780,24,45,253,0.0
36406.23,803,778,25,46,252,0.0
36416.23,805,778,27,44,252,0.0
36426.25,803,779,24,44,252,0.0
36436.23,804,779,25,44,252,0.0
36446.22,806,781,25,43,253,0.0
36456.24,804,780,24,45,252,0.0
36466.23,806,780,26,45,252,0.0
36476.23,805,779,26,44,252,0.0
36486.23,803,780,23,43,252,-0.0333
36496.25,805,781,24,45,252,0.0
36506.23,805,780,25,45,252,0.0
36516.24,805,779,26,45,252,0.0
36526.24,805,779,26,44,252,0.0
36536.25,807,780,27,44,253,0.0
36546.23,809,785,24,43,254,-0.0333
36556.24,804,779,25,44,251,0.0
36566.23,806,780,26,44,253,0.0
36576.27,805,778,27,45,252,0.0
36586.24,804,780,24,44,252,0.0
36596.23,805,779,26,43,252,0.0
36606.25,804,780,24,45,252,0.0
36616.24,809,780,29,45,252,0.0
36626.25,803,780,23,46,253,0.0
36636.26,804,780,24,44,252,0.0
36646.23,804,779,25,44,252,0.0
36656.25,804,779,25,44,253,0.0
36666.23,805,779,26,43,253,0.0
36676.24,804,781,23,45,252,0.0
36686.23,803,779,24,44,252,0.0
36696.24,803,776,27,44,252,0.0
36706.25,806,779,27,45,252,0.0
36716.26,808,780,28,44,252,0.0
36726.23,804,779,25,43,253,0.0
36736.26,804,780,24,45,253,0.0
36746.23,805,780,25,44,252,-0.0333
36756.23,804,779,25,43,252,0.0
36766.23,806,779,27,45,252,0.0
36776.24,805,779,26,43,252,0.0
36786.23,811,784,27,45,254,0.0
36796.23,804,780,24,45,252,0.0
36806.25,802,780,22,46,253,0.0
36816.23,806,779,27,45,252,-0.0333
36826.25,805,779,26,45,253,0.0
36836.23,805,778,27,44,252,0.0
36846.23,804,779,25,46,252,0.0
36856.25,805,781,24,44,252,0.0
36866.23,804,779,25,44,252,0.0
36876.23,804,779,25,43,252,0.0
36886.26,803,778,25,44,253,-0.0333
36896.25,804,780,24,44,251,0.0
36906.23,806,780,26,44,252,0.0
36916.23,805,780,25,44,251,0.0
36926.24,804,778,26,44,252,0.0
36936.25,805,776,29,44,250,0.0
36946.26,804,780,24,43,252,0.0
36956.23,804,779,25,45,253,0.0
36966.25,804,779,25,45,252,0.0
36976.25,805,780,25,46,253,0.0
36986.23,806,781,25,43,253,0.0
36996.23,803,779,24,44,252,0.0
37006.25,805,780,25,45,252,0.0
37016.23,805,780,25,44,252,0.0
37026.23,808,784,24,44,254,0.0
37036.25,806,780,26,45,252,0.0
37046.23,805,780,25,44,252,0.0
37056.23,805,781,24,43,252,0.0
37066.22,804,779,25,44,253,0.0
37076.23,799,778,21,45,251,-0.0333
37086.25,804,779,25,44,253,0.0
37096.23,803,779,24,44,252,0.0
37106.23,804,779,25,45,252,0.0
37116.23,805,780,25,43,252,0.0
37126.26,804,778,26,44,252,0.0
37136.22,805,779,26,44,253,0.0
37146.26,805,779,26,44,253,0.0
37156.26,805,780,25,44,252,0.0
37166.24,803,776,27,43,254,0.0
37176.25,805,776,29,44,252,0.0
37186.23,804,778,26,44,252,0.0
37196.23,809,784,25,44,254,0.0
37206.25,803,778,25,44,252,0.0
37216.25,806,781,25,46,252,0.0
37226.27,808,779,29,45,252,-0.0333
37236.22,805,779,26,45,252,0.0
37246.23,805,778,27,44,253,0.0
37256.25,808,774,34,43,250,0.0
37266.23,809,781,28,45,253,0.0
37276.23,804,779,25,44,253,0.0
37286.23,805,780,25,45,252,0.0
37296.23,804,779,25,44,252,0.0
37306.25,804,779,25,43,252,0.0
37316.23,806,780,26,43,253,0.0
37326.23,809,780,29,44,252,0.0
37336.23,803,780,23,44,252,0.0
37346.23,812,775,37,45,252,0.0
37356.24,803,779,24,44,253,0.0
37366.23,810,784,26,44,254,0.0
37376.24,804,779,25,44,252,0.0
37386.26,806,780,26,45,253,-0.0333
37396.23,807,779,28,43,252,0.0
37406.24,806,780,26,43,252,0.0
37416.23,805,778,27,45,251,0.0
37426.23,805,779,26,44,253,0.0
37436.25,810,783,27,44,252,0.0
37446.25,802,779,23,45,252,0.0
37456.23,805,780,25,45,252,0.0
37466.25,804,779,25,45,252,0.0
37476.24,804,779,25,44,252,0.0
37486.23,805,780,25,45,253,0.0
37496.23,806,779,27,44,252,0.0
37506.23,807,780,27,45,252,0.0
37519.47,805,779,26,44,253,0.0
37526.23,806,779,27,46,253,0.0
37536.26,811,784,27,44,254,0.0
37546.23,805,778,27,44,252,0.0
37556.23,805,781,24,44,253,0.0
37566.27,804,778,26,45,252,0.0
37576.23,806,780,26,44,252,0.0333
37586.25,805,778,27,44,252,0.0
37596.24,805,779,26,44,252,0.0
37606.23,809,780,29,45,252,0.0
37616.23,805,777,28,44,251,0.0
37626.25,804,780,24,44,252,0.0
37636.26,804,778,26,45,252,0.0
37646.25,804,779,25,45,253,0.0
37656.23,803,780,23,45,253,0.0
37666.23,806,780,26,44,251,0.0
37676.23,804,778,26,44,251,0.0333
37686.24,801,778,23,43,252,0.0
37696.23,803,777,26,45,252,0.0
37706.25,808,777,31,44,255,0.0
37716.23,804,779,25,45,252,0.0
37726.26,805,779,26,45,252,0.0
37736.23,806,780,26,45,252,0.0
37746.24,807,780,27,45,252,0.0
37756.23,805,779,26,44,252,0.0
37766.25,804,779,25,45,252,0.0
37776.23,809,784,25,44,254,0.0
37786.23,805,780,25,44,252,0.0
37796.23,806,779,27,45,252,0.0
37806.23,803,778,25,45,252,0.0
37816.23,804,779,25,45,252,0.0
37826.23,804,781,23,45,253,0.0
37836.25,804,780,24,44,253,0.0
37846.24,804,779,25,44,252,0.0
37856.23,801,778,23,44,252,0.0
37866.23,805,779,26,44,252,0.0
37876.25,806,777,29,44,253,0.0
37886.23,801,784,17,44,252,0.0
37896.26,803,781,22,45,252,0.0
37906.26,805,780,25,46,252,0.0
37916.24,805,780,25,44,252,0.0
37926.25,805,778,27,44,252,0.0
37936.23,806,779,27,44,252,0.0
37946.24,807,783,24,43,254,0.0
37956.23,803,779,24,43,252,0.0
37966.23,806,780,26,45,253,-0.0333
37976.23,806,778,28,44,251,0.0
37986.23,797,774,23,46,251,0.0
37996.23,805,778,27,44,252,0.0
38006.23,806,779,27,44,252,0.0
38016.23,806,779,27,43,252,0.0
38026.23,803,780,23,44,252,0.0
38036.23,804,778,26,45,252,0.0
38046.26,804,778,26,44,252,0.0
38056.23,804,779,25,44,253,0.0
38066.23,802,781,21,45,253,0.0
38076.27,802,780,22,44,252,0.0
38086.23,804,779,25,43,253,0.0
38096.24,805,779,26,45,252,0.0
38106.24,804,779,25,44,253,0.0
38116.23,810,784,26,44,254,0.0
38126.23,804,779,25,44,252,0.0
38136.25,807,781,26,45,253,0.0
38146.27,805,779,26,45,252,0.0
38156.23,805,784,21,44,252,0.0
38166.23,805,778,27,45,252,0.0
38176.23,805,780,25,45,252,0.0
38186.23,810,782,28,43,252,0.0
38196.23,805,781,24,44,252,0.0
38206.23,805,779,26,44,252,0.0
38216.25,804,780,24,44,251,0.0
38226.24,803,778,25,44,252,0.0
38236.23,806,780,26,43,253,0.0
38246.23,807,779,28,45,252,0.0
38256.24,804,779,25,45,252,0.0
38266.23,805,780,25,44,251,0.0
38276.23,805,779,26,45,252,0.0
38286.25,805,781,24,44,253,0.0
38296.24,805,779,26,45,252,0.0
38306.23,806,780,26,45,252,0.0
38316.27,806,779,27,45,252,0.0
38326.23,804,779,25,43,252,-0.0333
38336.24,801,772,29,45,252,0.0
38346.24,804,779,25,44,252,0.0
38356.23,809,784,25,44,254,0.0
38366.24,806,779,27,45,253,0.0
38376.25,806,780,26,45,252,0.0
38386.23,805,781,24,45,252,-0.0333
38396.23,804,780,24,43,252,0.0
38406.24,804,779,25,45,252,0.0
38416.23,805,779,26,44,253,0.0
38426.25,807,780,27,45,255,0.0
38436.24,804,779,25,43,252,0.0
38446.23,804,780,24,46,252,0.0
38456.26,805,780,25,45,252,0.0
38466.23,804,779,25,45,252,0.0
38476.25,806,779,27,44,252,0.0
38486.23,805,779,26,45,253,0.0
38496.24,808,785,23,44,254,0.0
38506.24,804,779,25,44,252,0.0
38516.25,799,781,18,45,252,0.0
38526.23,805,779,26,43,252,0.0
38536.23,807,780,27,44,252,0.0
38546.23,805,779,26,44,252,0.0
38556.24,805,780,25,44,252,0.0
38566.24,807,780,27,44,252,0.0
38576.24,805,780,25,45,252,0.0
38586.25,804,780,24,44,252,0.0
38596.23,804,779,25,44,252,0.0
38606.24,804,779,25,44,251,0.0
38616.23,807,780,27,45,253,0.0
38626.25,806,780,26,45,253,0.0
38636.23,806,780,26,45,252,0.0
38646.23,805,779,26,44,252,0.0
38656.23,805,779,26,45,252,0.0
38666.25,810,784,26,44,254,0.0
38676.23,803,779,24,43,252,0.0
38686.23,805,780,25,46,252,0.0
38696.23,804,778,26,45,252,0.0
38706.23,805,778,27,45,252,0.0
38716.26,805,779,26,45,252,0.0
38726.23,804,779,25,44,252,0.0
38736.23,806,780,26,45,252,0.0
38746.24,804,780,24,46,253,-0.0333
38756.23,805,779,26,44,252,0.0
38766.26,805,779,26,44,252,0.0
38776.24,804,779,25,43,252,0.0
38786.26,813,775,38,44,252,0.0
38796.24,806,779,27,45,252,0.0
38806.22,805,779,26,44,252,0.0
38816.23,805,780,25,43,253,0.0
38826.23,805,779,26,45,252,0.0
38836.23,808,785,23,44,254,0.0
38846.24,804,779,25,44,252,0.0
38856.25,806,780,26,45,253,0.0
38866.27,806,779,27,44,252,-0.0333
38876.24,799,780,19,44,254,0.0
38886.23,805,779,26,44,252,0.0
38896.25,805,778,27,44,252,0.0
38906.23,810,780,30,43,252,0.0
38916.23,804,779,25,44,252,0.0
38926.23,805,780,25,45,252,0.0
38936.23,803,779,24,45,252,0.0
38946.23,805,779,26,43,253,0.0
38956.26,806,778,28,45,252,0.0
38966.23,802,779,23,44,252,0.0
38976.22,804,779,25,44,252,0.0
38986.22,804,779,25,44,252,0.0
38996.24,805,780,25,44,252,0.0
39006.22,810,784,26,45,254,0.0
39016.24,804,778,26,44,252,0.0
39026.25,806,780,26,45,253,0.0
39036.27,806,779,27,44,252,0.0
39046.24,805,779,26,44,252,0.0
39056.25,799,779,20,44,253,0.0
39066.23,805,780,25,44,252,0.0
39076.23,808,780,28,44,252,0.0
39086.24,800,780,20,44,252,0.0
39096.26,805,780,25,44,253,0.0
39106.27,804,778,26,44,252,0.0
39116.23,806,779,27,44,252,0.0
39126.26,806,780,26,44,253,0.0
39136.22,805,779,26,45,252,0.0
39146.25,804,780,24,45,251,0.0
39156.24,806,781,25,43,251,0.0
39166.23,805,779,26,43,253,0.0
39176.26,805,779,26,43,252,0.0
39186.23,803,779,24,45,253,0.0
39196.23,805,780,25,44,253,0.0
39206.27,805,780,25,45,253,0.0
39216.24,804,777,27,44,252,0.0
39226.23,805,779,26,45,252,0.0
39236.25,803,780,23,45,252,0.0
39246.24,808,785,23,45,254,0.0
39256.24,804,779,25,45,252,0.0
39266.26,806,780,26,44,253,0.0
39276.23,806,780,26,45,252,0.0
39286.24,803,778,25,43,253,0.0
39296.23,806,779,27,44,252,0.0
39306.25,805,780,25,45,253,-0.0333
39316.25,808,781,27,44,253,0.0
39326.24,803,779,24,45,252,0.0
39336.25,806,780,26,44,253,0.0
39346.23,805,778,27,44,251,0.0
39356.23,805,780,25,44,252,0.0
39366.25,806,781,25,45,252,0.0
39376.24,807,780,27,44,251,0.0
39386.23,802,779,23,45,253,0.0
39396.22,805,779,26,44,252,0.0
39406.24,805,779,26,44,252,0.0
39416.26,812,777,35,44,251,0.0
39426.24,805,779,26,43,253,0.0
39436.26,806,781,25,43,253,0.0
39446.23,806,780,26,45,251,0.0
39456.23,804,779,25,44,252,0.0
39466.25,804,777,27,43,253,0.0
39476.23,801,774,27,45,252,0.0
39486.24,808,785,23,45,254,0.0
39496.23,805,778,27,44,252,0.0
39506.23,799,783,16,45,253,0.0
39516.23,805,778,27,44,252,0.0
39526.23,804,778,26,43,252,0.0
39536.26,804,779,25,44,251,0.0
39546.23,805,779,26,44,252,0.0
39556.22,806,780,26,45,252,0.0
39566.24,805,779,26,44,252,0.0
39576.25,805,780,25,44,251,0.0
39586.23,805,778,27,44,252,0.0
39596.24,804,780,24,45,253,0.0
39606.25,805,780,25,45,253,0.0
39616.25,807,779,28,44,253,0.0
39626.23,804,779,25,45,252,0.0
39636.24,805,779,26,43,252,0.0
39646.24,804,779,25,45,251,0.0
39656.23,806,780,26,45,253,0.0
39666.25,805,779,26,44,252,0.0
39676.25,806,780,26,45,252,0.0
39686.23,805,784,21,46,252,0.0
39696.24,804,779,25,44,252,-0.0333
39706.23,806,779,27,45,252,0.0
39716.25,805,779,26,43,253,0.0
39726.23,809,782,27,43,253,0.0
39736.23,802,778,24,45,252,0.0
39746.23,806,780,26,45,253,0.0
39756.23,805,779,26,45,252,0.0
39766.22,806,778,28,44,252,0.0
39776.25,800,779,21,43,252,0.0
39786.22,804,779,25,44,252,0.0
39796.25,806,780,26,44,251,0.0
39806.23,803,779,24,44,252,0.0
39816.23,804,780,24,44,252,0.0
39826.26,805,778,27,45,252,0.0
39836.23,810,780,30,44,252,0.0
39846.23,807,780,27,44,252,0.0
39856.26,805,779,26,45,252,0.0
39866.22,804,774,30,44,252,0.0
39876.23,805,779,26,44,252,0.0
39886.25,806,779,27,45,253,0.0
39896.25,809,784,25,44,253,0.0
39906.24,804,779,25,44,252,0.0
39916.23,807,780,27,45,252,0.0
39926.23,804,779,25,44,252,0.0
39936.24,805,779,26,45,252,0.0
39946.26,805,779,26,43,252,0.0
39956.23,804,784,20,45,253,0.0
39966.23,807,780,27,45,252,0.0
39976.23,804,780,24,44,252,0.0
39986.25,806,780,26,44,253,0.0
39996.26,805,779,26,44,252,0.0
40006.24,804,780,24,44,252,0.0
40016.25,806,780,26,44,252,0.0
40026.27,806,780,26,45,251,0.0
40036.24,804,779,25,45,252,0.0
40046.23,806,779,27,45,252,0.0
40056.23,806,779,27,45,252,0.0
40066.23,811,784,27,45,253,0.0
40076.24,805,779,26,44,252,0.0
40086.25,805,780,25,44,253,0.0
40096.27,807,779,28,44,252,0.0
40106.23,804,778,26,44,252,0.0
40116.23,806,778,28,44,252,0.0
40126.24,805,778,27,45,252,0.0
40136.23,808,781,27,45,252,0.0
40146.23,805,780,25,44,253,0.0
40156.26,806,780,26,44,252,0.0
40166.26,806,778,28,44,252,0.0
40176.22,805,779,26,45,252,0.0
40186.25,807,780,27,44,253,0.0
40196.23,806,780,26,45,252,0.0
40206.24,805,779,26,44,252,0.0
40216.23,807,779,28,44,251,0.0
40226.22,804,776,28,45,253,0.0
40236.23,809,784,25,44,254,0.0
40246.25,803,779,24,45,252,0.0
40256.25,806,781,25,44,253,0.0
40266.23,806,779,27,44,252,0.0
40276.23,805,779,26,44,252,0.0
40286.23,806,779,27,44,253,0.0
40296.25,805,779,26,44,253,0.0
40306.25,807,780,27,44,252,0.0
40316.24,805,782,23,45,253,0.0
40326.23,805,779,26,44,252,0.0
40336.25,804,779,25,45,252,0.0
40346.23,804,779,25,44,252,0.0
40356.23,806,781,25,46,252,0.0
40366.23,807,779,28,45,252,0.0
40376.23,804,779,25,44,252,0.0
40386.23,805,779,26,44,251,0.0
40396.25,805,780,25,44,252,0.0
40406.26,807,775,32,44,250,0.0
40416.22,804,779,25,44,252,0.0
40426.26,806,780,26,44,253,0.0
40436.23,807,780,27,44,252,0.0
40446.23,804,779,25,44,252,0.0
40456.25,805,779,26,45,252,0.0
40466.25,807,780,27,45,251,0.0
40476.25,811,784,27,45,254,0.0
40486.25,805,779,26,44,252,0.0
40496.25,808,782,26,45,252,0.0
40506.27,806,777,29,44,253,0.0
40516.22,806,779,27,46,253,0.0
40526.23,806,779,27,44,252,0.0
40536.24,805,779,26,45,253,0.0
40546.23,806,780,26,44,253,0.0
40556.23,805,780,25,45,252,0.0
40566.25,807,780,27,44,253,0.0
40576.23,805,778,27,45,252,0.0
40586.23,807,774,33,44,252,0.0
40596.26,805,780,25,44,252,0.0
40606.26,806,779,27,45,252,0.0
40616.24,805,779,26,44,252,0.0
40626.25,807,779,28,45,251,0.0
40636.23,805,780,25,44,251,0.0
40646.25,808,784,24,44,253,0.0
40656.25,805,779,26,45,252,0.0
40666.23,806,780,26,45,253,0.0
40676.26,806,780,26,44,252,0.0
40686.24,805,780,25,44,253,0.0
40696.25,805,778,27,44,252,0.0
40706.23,806,779,27,44,252,0.0
40716.22,807,780,27,44,252,0.0
40726.23,806,779,27,45,252,0.0
40736.23,804,778,26,44,252,0.0
40746.25,804,779,25,45,252,0.0
40756.23,804,778,26,44,252,0.0
40766.25,803,786,17,45,252,0.0
40776.23,804,780,24,44,252,0.0
40786.24,805,779,26,45,253,0.0
40796.24,805,779,26,45,252,0.0
40806.23,806,780,26,44,252,0.0
40816.26,809,784,25,44,254,0.0
40826.22,804,779,25,44,253,0.0
40836.26,806,780,26,45,253,0.0
40846.26,805,779,26,45,252,0.0
40856.23,804,780,24,45,253,0.0
40866.23,806,779,27,44,252,0.0
40876.23,804,779,25,45,253,0.0
40886.24,808,781,27,44,253,0.0
40896.24,807,780,27,44,252,0.0
40906.26,807,780,27,44,253,0.0
40916.23,806,778,28,44,252,0.0
40926.24,805,779,26,44,253,0.0
40936.23,806,779,27,44,252,0.0
40946.23,807,779,28,45,250,0.0
40956.24,805,779,26,44,252,0.0
40966.23,806,778,28,44,252,0.0
40976.24,804,780,24,45,252,0.0
40986.27,809,785,24,44,254,-0.0333
40996.23,804,777,27,45,252,0.0
41006.23,805,781,24,44,253,0.0
41016.27,806,778,28,45,252,0.0
41026.23,805,779,26,43,252,0.0
41036.23,811,784,27,44,251,0.0
41046.24,804,777,27,44,252,0.0
41056.24,807,779,28,44,253,0.0
41066.23,806,780,26,45,253,0.0
41076.23,807,779,28,45,252,0.0
41086.26,805,779,26,45,252,0.0
41096.23,805,779,26,45,252,0.0
41106.23,806,781,25,43,253,0.0
41116.24,806,780,26,44,252,0.0
41126.24,805,780,25,44,250,0.0
41136.24,806,778,28,43,252,0.0
41146.23,805,779,26,44,252,0.0
41156.24,809,784,25,44,253,0.0
41166.24,805,779,26,44,252,0.0
41176.26,806,781,25,45,253,0.0
41186.23,805,778,27,45,252,0.0
41196.23,806,779,27,44,252,0.0
41206.26,805,779,26,43,252,0.0
41216.23,808,775,33,44,252,0.0
41226.23,807,780,27,46,252,0.0
41236.24,805,780,25,44,253,0.0
41246.26,805,777,28,44,252,0.0
41256.26,804,779,25,45,252,0.0
41266.24,804,779,25,45,252,0.0
41276.23,803,780,23,45,253,0.0
41286.26,805,779,26,44,252,0.0
41296.23,805,779,26,44,252,0.0
41306.24,811,779,32,44,252,0.0
41316.24,805,779,26,45,252,0.0
41326.25,809,784,25,43,254,0.0
41336.24,805,780,25,44,252,0.0
41346.26,806,780,26,45,252,0.0
41356.23,805,780,25,44,252,0.0
41366.23,800,779,21,45,252,0.0
41376.23,807,780,27,45,253,0.0
41386.23,804,779,25,45,252,0.0
41396.23,805,779,26,45,251,0.0
41406.24,805,777,28,43,251,0.0
41416.23,806,780,26,44,253,0.0
41426.23,806,780,26,44,253,0.0
41436.23,804,779,25,44,253,0.0
41446.26,807,781,26,45,253,0.0
41456.27,805,780,25,44,252,0.0
41466.23,805,779,26,44,253,0.0
41476.23,805,779,26,45,252,0.0
41486.25,807,784,23,45,252,0.0
41496.25,808,785,23,44,253,0.0
41506.23,804,778,26,44,252,0.0
41516.26,807,781,26,46,252,0.0
41526.27,803,779,24,45,252,0.0
41536.23,806,779,27,45,251,0.0
41546.23,805,779,26,44,252,0.0
41556.25,804,779,25,45,252,-0.0333
41566.23,809,780,29,45,252,0.0
41576.23,805,782,23,45,253,0.0
41586.25,805,779,26,43,252,0.0
41596.26,805,778,27,44,251,0.0
41606.23,804,779,25,46,252,0.0
41616.23,806,780,26,45,253,0.0
41626.27,807,779,28,45,252,0.0
41636.24,805,779,26,44,252,0.0
41646.23,805,779,26,45,252,0.0
41656.25,805,779,26,44,252,0.0
41666.24,810,783,27,44,252,0.0
41676.23,803,779,24,45,252,0.0
41686.26,806,780,26,45,253,0.0
41696.23,804,779,25,44,252,0.0
41706.24,805,779,26,44,253,0.0333
41716.26,805,779,26,43,253,0.0
41726.24,804,779,25,44,252,0.0
41736.22,811,780,31,44,252,0.0
41746.24,804,780,24,45,252,0.0
41756.26,798,780,18,45,253,0.0333
41766.23,806,779,27,44,251,-0.0333
41776.24,804,779,25,45,252,0.0
41786.23,805,780,25,45,252,0.0
41796.23,806,780,26,45,252,0.0
41806.24,804,779,25,44,252,0.0
41816.23,804,779,25,45,252,0.0
41826.24,805,779,26,45,252,-0.0333
41836.23,807,780,27,44,253,0.0
41846.24,804,780,24,45,252,0.0
41856.23,806,780,26,45,253,0.0
41866.27,806,778,28,44,253,0.0
41876.25,804,779,25,45,253,0.0
41886.23,807,780,27,45,252,0.0
41896.25,806,780,26,43,252,0.0
41906.23,803,778,25,45,252,0.0
41916.24,803,779,24,45,252,0.0
41926.24,804,780,24,44,253,0.0
41936.23,799,779,20,43,250,0.0
41946.24,804,779,25,44,252,0.0
41956.23,806,780,26,44,253,0.0
41966.23,805,780,25,45,252,0.0
41976.23,803,780,23,44,252,0.0
41986.25,803,778,25,45,252,0.0
41996.23,806,779,27,45,252,0.0
42006.25,808,783,25,45,253,0.0
42016.23,803,777,26,44,252,0.0
42026.24,808,780,28,45,253,0.0
42036.27,806,778,28,44,253,0.0
42046.24,805,778,27,45,253,0.0
42056.23,804,778,26,45,252,0.0
42066.25,806,779,27,45,252,0.0
42076.24,809,781,28,45,252,0.0
42086.25,805,779,26,43,253,0.0
42096.23,805,779,26,44,252,0.0
42106.26,805,779,26,45,251,0.0
42116.23,805,780,25,45,252,0.0
42126.23,804,780,24,44,252,0.0
42136.23,804,780,24,43,252,0.0
42146.23,805,779,26,45,252,0.0
42156.23,805,780,25,45,252,0.0
42166.23,805,780,25,44,252,0.0
42176.23,811,784,27,44,253,0.0
42186.24,806,779,27,45,252,0.0
42196.25,807,779,28,44,253,0.0
42206.23,806,778,28,45,253,0.0
42216.24,806,779,27,44,252,-0.0333
42226.26,805,779,26,45,252,0.0
42236.25,806,779,27,44,252,0.0
42246.24,806,780,26,45,252,0.0
42256.24,805,780,25,43,252,0.0
42266.25,806,780,26,44,252,0.0
42276.25,805,779,26,45,252,0.0
42286.24,806,779,27,45,253,0.0
42296.23,807,774,33,44,252,0.0
42306.23,806,780,26,45,252,0.0
42316.24,806,779,27,44,252,0.0
42326.24,805,778,27,45,253,0.0
42336.23,805,779,26,45,252,0.0
42346.23,810,784,26,44,254,0.0
42356.25,805,779,26,43,252,0.0
42366.23,807,780,27,44,253,0.0
42376.23,803,779,24,45,250,0.0
42386.24,807,784,23,44,252,0.0
42396.23,806,779,27,44,252,0.0
42406.24,806,779,27,44,252,0.0
42416.23,809,781,28,44,252,0.0
42426.24,807,780,27,43,252,-0.0333
42436.25,806,780,26,43,252,0.0
42446.23,805,778,27,44,252,0.0
42456.22,805,779,26,44,253,0.0
42466.23,806,780,26,45,252,0.0
42476.23,805,786,19,45,250,0.0
42486.24,805,779,26,44,253,0.0
42496.23,804,780,24,45,251,0.0
42506.24,805,780,25,43,252,0.0
42516.26,806,780,26,44,253,0.0
42526.25,805,779,26,44,252,0.0
42536.25,807,780,27,44,253,0.0
42546.27,805,779,26,45,252,0.0
42556.24,804,779,25,44,252,0.0
42566.24,807,777,30,45,252,0.0
42576.23,806,780,26,44,252,0.0
42586.23,809,785,24,44,254,0.0
42596.25,804,779,25,44,252,0.0
42606.26,807,780,27,44,253,0.0
42616.26,806,779,27,44,252,0.0
42626.23,805,780,25,44,252,0.0
42636.26,805,778,27,44,252,0.0
42646.23,806,780,26,44,252,0.0
42656.23,807,775,32,43,251,0.0
42666.23,806,780,26,44,252,0.0
42676.23,806,780,26,45,252,0.0
42686.23,805,778,27,45,252,0.0
42696.24,805,778,27,45,252,-0.0333
42706.26,806,779,27,44,253,0.0
42716.25,806,778,28,44,252,0.0
42726.24,809,779,30,44,253,0.0
42736.24,806,779,27,44,252,0.0
42746.23,803,781,22,45,252,0.0
42756.25,809,784,25,45,254,0.0
42766.24,804,777,27,43,252,0.0
42776.25,807,779,28,43,252,0.0
42786.23,805,778,27,45,252,0.0
42796.24,806,780,26,44,253,0.0
42806.25,806,779,27,44,251,0.0
42816.23,807,778,29,45,252,0.0
42826.23,809,780,29,44,252,0.0
42836.25,805,781,24,45,253,0.0
42846.25,806,779,27,45,253,0.0
42856.23,805,777,28,44,252,0.0
42866.23,805,779,26,45,252,0.0
42876.26,806,780,26,44,253,0.0
42886.25,805,780,25,45,253,-0.0333
42896.23,805,778,27,45,252,0.0
42906.24,806,779,27,44,252,0.0
42916.25,806,779,27,44,252,0.0
42926.23,805,784,21,44,253,0.0
42936.23,804,780,24,44,252,0.0
42946.25,808,780,28,45,253,0.0
42956.23,806,780,26,45,252,0.0333
42966.23,805,779,26,45,252,0.0
42976.24,806,779,27,44,252,0.0
42986.24,805,780,25,44,252,0.0
42996.25,809,784,25,44,254,0.0
43006.25,806,778,28,44,252,0.0
43016.23,807,781,26,46,253,0.0
43026.26,805,779,26,44,252,0.0
43036.24,805,777,28,45,252,0.0
43046.26,806,779,27,43,252,0.0
43056.24,803,779,24,44,253,0.0
43066.25,810,780,30,45,252,0.0
43076.25,806,780,26,44,252,0.0
43086.23,807,780,27,43,252,0.0
43096.23,806,778,28,45,251,0.0
43106.24,806,779,27,44,253,0.0
43116.25,807,780,27,45,252,0.0
43126.24,807,779,28,44,253,0.0
43136.24,806,779,27,43,252,0.0
43146.25,803,780,23,43,252,0.0
43156.23,807,780,27,44,252,0.0
43166.26,807,780,27,45,252,0.0
43176.23,806,778,28,43,252,0.0
43186.23,807,780,27,44,253,-0.0333
43196.23,808,781,27,43,252,0.0
43206.23,806,778,28,45,252,0.0
43216.24,806,779,27,45,251,0.0
43226.23,806,781,25,45,252,0.0
43236.25,812,784,28,44,254,0.0
43246.24,806,778,28,44,252,0.0
43256.26,806,779,27,44,253,-0.0333
43266.26,807,777,30,45,252,0.0
43276.24,804,780,24,43,251,0.0
43286.26,803,775,28,44,252,0.0
43296.25,806,780,26,43,253,0.0
43306.23,808,780,28,43,252,0.0
43316.23,805,779,26,44,252,0.0
43326.23,805,779,26,44,253,0.0
43336.26,806,778,28,44,252,0.0
43346.25,806,779,27,44,252,0.0
43356.25,806,779,27,45,252,0.0
43366.23,807,779,28,46,252,0.0
43376.22,807,781,26,45,251,0.0
43386.23,803,780,23,44,253,0.0
43396.25,806,779,27,43,253,0.0
43406.23,806,779,27,45,253,0.0
43416.23,806,778,28,44,252,0.0
43426.25,806,779,27,44,253,0.0
43436.27,807,781,26,45,252,0.0
43446.23,807,779,28,44,253,0.0
43456.24,807,778,29,45,252,0.0
43466.25,806,780,26,46,253,0.0
43476.26,809,784,25,44,253,0.0
43486.23,806,779,27,43,252,0.0
43496.47,806,780,26,45,253,0.0
43506.24,806,779,27,45,251,0.0
43516.23,807,779,28,45,253,0.0
43526.23,804,779,25,44,252,0.0
43536.25,806,780,26,44,252,0.0
43546.23,806,779,27,43,252,0.0
43556.23,806,779,27,44,253,0.0
43566.25,807,779,28,44,252,0.0
43576.23,807,777,30,45,252,0.0
43586.23,807,780,27,45,252,0.0
43596.23,807,779,28,45,253,0.0
43606.23,805,780,25,44,252,0.0
43616.23,807,778,29,45,252,0.0
43626.23,801,779,22,45,251,0.0
43636.23,807,779,28,44,252,0.0
43646.23,806,775,31,44,252,0.0
43656.23,806,779,27,44,252,0.0
43666.23,807,780,27,45,253,0.0
43676.23,808,781,27,45,252,0.0
43686.24,806,779,27,44,252,0.0
43696.23,806,779,27,44,252,0.0
43706.25,806,778,28,45,253,0.0
43716.24,810,784,26,44,253,0.0
43726.24,807,779,28,43,252,0.0
43736.23,801,782,19,45,253,0.0
43746.26,808,779,29,45,252,0.0
43756.24,806,780,26,43,253,0.0
43766.26,806,778,28,44,252,0.0
43776.24,807,778,29,44,252,0.0333
43786.24,811,779,32,44,252,0.0
43796.23,806,779,27,45,253,0.0
43806.23,806,780,26,44,252,0.0
43816.25,806,778,28,44,251,0.0
43826.23,804,779,25,44,253,-0.0333
43836.23,806,779,27,45,253,0.0333
43846.27,806,780,26,44,252,0.0
43856.23,806,779,27,43,252,0.0
43866.24,805,779,26,44,252,0.0
43876.23,807,779,28,44,252,0.0
43886.24,810,785,25,43,254,0.0
43896.23,807,778,29,44,252,0.0
43906.25,807,780,27,44,253,0.0
43916.26,807,779,28,45,254,0.0
43926.23,806,778,28,43,252,0.0
43936.25,805,778,27,44,252,0.0
43946.23,807,776,31,44,250,0.0
43956.23,807,778,29,44,252,0.0
43966.23,806,779,27,44,252,0.0
43976.23,806,779,27,45,252,0.0
43986.26,804,778,26,44,251,0.0
43996.23,805,779,26,44,252,-0.0333
44006.23,806,776,30,44,254,0.0
44016.24,808,779,29,44,253,0.0
44026.26,805,777,28,44,251,0.0
44036.23,805,779,26,42,252,0.0
44046.26,808,777,31,43,252,-0.0333
44056.25,805,779,26,44,252,0.0
44066.23,807,777,30,44,251,0.0
44076.24,805,776,29,43,252,0.0
44086.23,804,775,29,45,251,0.0
44096.23,803,780,23,45,253,0.0
44106.23,807,778,29,44,252,0.0
44116.24,805,778,27,44,252,0.0
44126.24,803,777,26,44,252,0.0
44136.25,807,780,27,44,252,0.0
44146.25,806,779,27,44,251,0.0
44156.23,805,776,29,45,252,0.0
44166.24,803,778,25,44,251,0.0
44176.23,807,778,29,45,252,0.0
44186.23,808,777,31,44,251,0.0
44196.23,805,778,27,43,252,0.0
44206.23,805,778,27,43,252,0.0
44216.23,805,778,27,43,252,0.0
44226.23,808,780,28,44,253,0.0
44236.23,803,778,25,44,252,0.0
44246.26,806,779,27,44,252,0.0
44256.23,806,779,27,44,252,0.0
44266.25,810,782,28,46,253,0.0
44276.24,803,780,23,44,252,0.0
44286.23,806,779,27,44,252,0.0
44296.24,807,777,30,44,252,0.0
44306.24,805,778,27,44,251,0.0
44316.23,806,779,27,43,251,0.0
44326.25,809,779,30,44,252,0.0
44336.23,807,775,32,45,251,0.0
44346.23,802,776,26,44,251,-0.0333
44356.24,802,773,29,45,251,0.0
44366.26,806,775,31,44,251,0.0
44376.27,804,776,28,46,251,0.0
44386.25,802,775,27,44,251,0.0
44396.23,804,775,29,45,252,0.0
44406.24,807,779,28,43,252,0.0
44416.25,797,771,26,46,250,0.0
44426.28,803,771,32,45,251,0.0
44436.26,808,779,29,44,253,0.0
44446.23,804,777,27,44,251,0.0
44457.32,802,773,29,45,251,0.0
44466.24,803,777,26,44,250,0.0
44476.23,806,778,28,43,251,0.0
44486.25,799,774,25,44,252,0.0
44496.27,802,770,32,45,249,0.0
44506.25,805,775,30,44,251,0.0
44516.25,802,775,27,44,250,0.0
44526.27,801,774,27,45,249,0.0
44536.26,807,780,27,45,252,0.0
44546.23,803,772,31,45,250,-0.0333
44556.23,803,778,25,45,251,0.0
44566.24,807,778,29,45,252,0.0
44576.23,807,781,26,45,252,0.0
44586.23,806,778,28,46,251,0.0
44596.24,799,772,27,43,249,0.0333
44606.26,806,778,28,44,252,0.0
44616.25,803,773,30,45,251,0.0
44626.43,801,778,23,45,251,0.0
44636.23,802,773,29,44,249,0.0
44646.26,806,779,27,44,251,0.0
44656.24,804,777,27,44,251,0.0
44666.23,802,773,29,43,251,0.0
44676.23,808,775,33,45,250,0.0
44686.23,807,779,28,45,252,0.0
44696.23,802,773,29,45,250,0.0
44706.23,796,773,23,43,248,0.0
44716.24,805,774,31,44,253,0.0
44726.23,814,773,41,44,253,0.0
44736.27,800,774,26,44,250,0.0
44746.23,808,779,29,45,251,0.0
44756.23,807,778,29,45,252,0.0
44766.27,802,776,26,44,252,0.0
44776.23,800,774,26,44,250,0.0
44786.28,804,775,29,45,251,0.0
44796.25,804,774,30,43,251,0.0
44806.26,799,772,27,44,250,0.0
44816.26,801,775,26,44,249,0.0
44826.41,800,771,29,45,250,0.0
44836.23,807,780,27,43,252,0.0
44846.26,808,779,29,45,252,0.0
44856.23,806,779,27,45,252,0.0
44866.24,804,777,27,45,252,0.0
44876.22,807,776,31,43,252,0.0
44886.23,808,780,28,44,252,0.0
44896.22,806,779,27,44,252,0.0
44906.24,802,775,27,46,252,0.0
44916.24,802,775,27,45,251,0.0
44926.25,806,779,27,45,252,0.0
44936.25,802,772,30,44,250,0.0
44946.23,804,777,27,44,251,0.0
44956.23,807,780,27,43,251,0.0
44966.24,804,776,28,46,251,0.0
44976.24,804,778,26,44,252,0.0
44986.25,807,779,28,44,252,0.0
44996.25,814,775,39,43,250,0.0
45006.23,807,776,31,45,252,0.0
45016.23,807,777,30,43,250,0.0
45026.23,805,778,27,45,252,0.0
45036.25,807,777,30,44,252,0.0
45046.25,806,778,28,45,251,0.0
45056.25,807,778,29,44,252,0.0
45066.23,804,777,27,44,251,0.0
45076.25,806,779,27,44,251,0.0
45086.33,808,768,40,45,248,0.0
45096.24,803,774,29,44,250,0.0
45106.26,806,777,29,44,252,0.0
45116.25,807,778,29,44,252,0.0
45126.27,803,775,28,44,250,0.0
45136.23,804,776,28,44,251,0.0
45146.26,803,777,26,44,250,-0.0333
45156.27,801,778,23,44,251,0.0
45166.24,802,775,27,44,249,0.0
45176.23,802,778,24,45,252,0.0
45186.24,807,778,29,44,252,0.0
45196.26,804,775,29,45,251,0.0
45206.23,804,777,27,44,252,0.0
45216.23,804,780,24,44,252,-0.0333
45226.24,807,781,26,45,252,0.0
45236.27,806,780,26,45,253,0.0
45246.25,805,775,30,43,251,0.0
45256.23,806,779,27,44,251,0.0
45266.27,806,775,31,44,251,0.0
45276.25,805,780,25,44,252,0.0
45286.27,806,777,29,47,252,0.0
45296.24,810,779,31,43,253,0.0
45306.23,807,777,30,44,252,0.0
45316.23,806,778,28,44,252,0.0
45326.23,800,777,23,44,250,0.0
45336.23,806,779,27,44,251,0.0
45346.23,807,779,28,45,252,0.0
45356.26,806,778,28,45,252,0.0
45366.23,805,778,27,45,252,0.0
45376.23,805,780,25,45,252,0.0
45386.24,806,778,28,44,252,0.0
45396.25,806,777,29,44,252,0.0
45406.23,805,777,28,45,252,0.0333
45416.23,807,779,28,44,252,0.0
45426.26,807,778,29,45,252,0.0333
45436.24,805,779,26,44,253,0.0
45446.26,807,772,35,44,253,0.0
45456.23,806,779,27,45,252,0.0
45466.23,805,777,28,44,252,0.0
45476.23,804,778,26,43,252,0.0
45486.41,802,774,28,44,250,0.0
45496.24,807,777,30,44,251,0.0
45506.25,805,779,26,44,251,0.0
45516.23,808,779,29,45,252,0.0
45526.24,804,780,24,44,251,0.0
45536.23,811,785,26,45,255,0.0
45546.24,807,777,30,45,253,0.0
45556.27,807,779,28,44,252,0.0
45566.23,806,780,26,44,252,0.0
45576.25,806,779,27,44,251,0.0
45586.23,799,774,25,43,250,0.0
45596.24,807,779,28,45,252,0.0
45606.24,807,778,29,43,252,0.0
45616.24,807,777,30,43,251,0.0
45626.25,803,780,23,44,253,0.0
45636.23,807,777,30,44,253,0.0
45646.25,805,778,27,44,252,0.0
45656.25,805,777,28,44,252,0.0
45666.23,808,779,29,45,252,-0.0333
45676.23,805,778,27,45,252,0.0
45686.23,803,771,32,45,251,0.0
45696.23,807,776,31,43,252,0.0
45706.23,807,778,29,44,252,0.0
45716.26,807,781,26,45,254,0.0
45726.23,806,778,28,44,252,0.0
45736.23,807,780,27,45,252,0.0
45746.27,807,780,27,44,252,0.0
45756.25,804,777,27,44,253,0.0
45766.23,807,777,30,44,252,-0.0333
45776.23,809,778,31,45,252,0.0
45786.23,812,782,30,44,254,0.0
45796.24,806,778,28,45,252,0.0
45806.4,809,784,25,45,250,0.0
45816.27,807,778,29,44,252,0.0
45826.25,806,778,28,44,252,0.0
45836.26,807,777,30,45,252,0.0
45846.23,807,778,29,44,252,0.0
45856.23,807,777,30,44,251,0.0
45866.25,807,777,30,44,252,0.0
45876.26,809,779,30,45,252,0.0
45886.25,806,779,27,45,252,0.0
45896.23,811,777,34,43,256,0.0
45906.24,806,778,28,44,251,0.0
45916.25,807,780,27,45,252,0.0
45926.26,807,778,29,45,252,0.0
45936.25,806,779,27,44,252,0.0
45946.25,807,777,30,45,252,0.0
45956.23,806,780,26,44,252,0.0
45966.28,806,777,29,44,252,0.0
45976.24,805,778,27,44,251,0.0
45986.24,805,774,31,44,254,0.0
45996.25,807,778,29,45,252,0.0
46006.27,805,776,29,44,251,0.0
46016.23,807,778,29,44,252,0.0
