time_ms,temp_0,temp_1,temp_0_1,diff_p,abs_p,sfm3300
0.73,822,779,43,42,252,0.0333
12.9,829,784,45,42,254,0.0
24.85,823,786,37,41,253,0.0
36.89,824,780,44,42,252,0.0
48.94,823,780,43,41,253,0.0
61.49,822,779,43,42,252,0.0
74.06,827,783,44,42,253,0.0
86.29,827,783,44,42,254,0.0
97.98,827,783,44,41,254,0.0
109.88,827,783,44,42,254,0.0
121.57,821,778,43,41,252,0.0
133.75,827,784,43,42,254,0.0
145.67,825,783,42,42,254,0.0
157.41,823,781,42,40,253,0.0
178.0,827,783,44,42,254,0.0
189.95,826,784,42,40,253,0.0
201.91,827,782,45,42,254,0.0
213.62,822,779,43,42,252,0.0
225.72,827,783,44,42,255,0.0
237.63,827,784,43,42,254,0.0
249.3,824,780,44,42,252,0.0
262.18,826,784,42,41,254,0.0
274.04,821,778,43,41,252,0.0
285.99,827,783,44,41,255,0.0
297.91,827,782,45,41,254,0.0
309.63,820,775,45,42,252,0.0
323.05,827,784,43,42,254,0.0
335.03,818,775,43,42,251,0.0
347.56,826,778,48,41,255,0.0
359.84,827,783,44,42,254,0.0
371.6,823,778,45,42,253,0.0
384.08,832,778,54,42,254,0.0
396.03,827,783,44,41,254,0.0
407.78,824,780,44,41,252,0.0
420.74,825,784,41,41,255,0.0
432.54,823,779,44,41,252,0.0
444.58,826,784,42,41,254,0.0
456.49,827,784,43,42,254,0.0
468.24,823,779,44,42,252,0.0
480.48,827,784,43,41,254,0.0
492.4,822,785,37,42,253,0.0
504.35,826,783,43,42,254,0.0
516.27,828,782,46,42,254,0.0
528.05,818,780,38,42,253,0.0
541.07,828,783,45,42,254,0.0
553.02,823,779,44,42,252,0.0
564.98,831,784,47,42,254,0.0
576.93,827,783,44,42,254,0.0
588.67,823,780,43,41,252,0.0
601.69,827,783,44,43,254,0.0
613.63,826,779,47,41,253,0.0
625.58,827,783,44,41,254,0.0
637.95,828,782,46,42,254,0.0
649.71,823,778,45,42,252,0.0
662.27,826,783,43,42,254,0.0
674.18,823,779,44,41,254,0.0
685.9,822,778,44,42,253,0.0
698.7,825,783,42,42,253,0.0
710.55,823,779,44,41,253,0.0
722.61,824,783,41,42,253,0.0
734.53,827,782,45,42,254,0.0
746.35,822,779,43,42,253,0.0
758.64,825,783,42,42,254,0.0
770.55,823,778,45,41,253,0.0
782.49,827,783,44,41,254,0.0
794.39,827,783,44,42,254,0.0
806.22,821,778,43,42,252,0.0
819.37,827,783,44,42,254,0.0
831.3,822,779,43,42,253,0.0
843.25,827,784,43,41,254,0.0
855.26,828,783,45,41,254,0.0
866.94,823,779,44,43,253,0.0
879.85,826,783,43,42,254,0.0
891.74,827,782,45,41,252,0.0
903.59,828,783,45,42,254,0.0
915.85,828,783,45,42,254,0.0
927.58,823,779,44,42,252,0.0
940.0,823,778,45,42,251,0.0
952.11,827,783,44,42,254,0.0
963.98,824,780,44,42,252,0.0
977.02,826,783,43,41,254,0.0
988.86,831,783,48,42,254,0.0
1001.76,832,786,46,42,255,0.0
1015.06,832,780,52,42,254,0.0
1028.33,831,783,48,42,254,0.0
1041.76,832,784,48,42,254,0.0
1054.56,831,783,48,42,253,0.0
1067.67,830,792,38,41,255,0.0
1080.46,830,782,48,41,253,0.0
1093.1,831,783,48,42,254,0.0
1106.57,833,785,48,42,255,0.0
1119.08,831,781,50,42,253,0.0
1132.67,833,784,49,43,254,0.0
1145.3,830,782,48,41,253,0.0
1157.91,831,791,40,41,255,0.0
1170.52,834,785,49,42,255,0.0
1182.87,829,781,48,42,253,0.0
1196.5,835,785,50,42,255,0.0
1209.06,830,782,48,43,253,0.0
1221.67,835,785,50,42,255,0.0
1234.21,833,786,47,43,254,0.0
1246.69,831,782,49,42,251,0.0
1259.71,834,784,50,42,255,0.0
1272.27,829,782,47,41,253,0.0
1285.28,834,783,51,41,254,0.0
1297.83,829,782,47,42,253,0.0
1310.28,828,781,47,42,253,-0.0333
1323.25,830,782,48,42,255,0.0
1335.89,830,782,48,42,253,0.0
1349.01,833,785,48,42,254,0.0
1361.56,831,782,49,42,254,0.0
1374.17,831,782,49,41,253,0.0
1387.58,831,785,46,42,254,0.0
1399.99,830,781,49,42,254,0.0
1413.62,831,786,45,43,254,0.0
1426.2,830,782,48,41,253,0.0
1438.86,834,784,50,41,254,0.0
1451.62,832,785,47,41,255,0.0
1464.07,831,777,54,41,254,0.0
1477.16,832,784,48,43,254,0.0
1489.73,829,781,48,42,253,0.0
1502.66,834,784,50,42,254,0.0
1515.25,831,783,48,42,253,0.0
1527.74,830,782,48,41,253,0.0
1540.57,831,782,49,43,253,0.0
1553.43,830,787,43,41,254,0.0
1566.62,832,784,48,42,254,0.0
1579.17,831,782,49,41,253,0.0
1591.78,831,783,48,41,253,0.0
1605.18,833,784,49,42,253,0.0
1617.65,831,781,50,42,253,0.0
1631.31,834,785,49,42,255,0.0
1643.89,827,783,44,42,254,0.0
1656.5,834,786,48,42,254,0.0
1669.12,834,786,48,42,255,0.0
1681.48,830,783,47,41,253,0.0
1695.14,831,783,48,42,254,-0.0333
1707.85,830,783,47,42,254,0.0
1720.49,834,786,48,42,254,0.0
1733.0,833,785,48,43,254,0.0
1745.36,829,782,47,42,254,0.0
1758.54,834,786,48,42,255,0.0
1771.1,831,779,52,41,253,0.0
1783.91,834,787,47,42,254,0.0
1796.48,831,784,47,43,254,0.0
1808.91,831,783,48,42,254,0.0
1821.67,835,786,49,43,255,0.0
1834.23,830,782,48,42,254,0.0
1847.25,836,785,51,41,255,0.0
1859.78,831,778,53,42,254,-0.0333
1872.36,830,781,49,41,253,0.0
1885.98,834,785,49,41,255,0.0
1898.44,831,783,48,42,254,0.0
1911.78,835,785,50,42,255,0.0
1924.32,831,783,48,41,254,0.0
1937.0,833,786,47,42,254,0.0
1950.05,835,791,44,41,255,0.0
1962.5,831,783,48,42,253,0.0
1976.02,834,787,47,42,255,0.0
1988.56,832,783,49,41,254,0.0
2001.16,835,784,51,41,254,0.0
2013.77,833,784,49,42,255,0.0
2026.12,831,783,48,42,254,0.0
2039.36,831,791,40,42,254,0.0
2051.95,830,783,47,42,253,0.0
2064.86,835,785,50,42,255,0.0
2077.37,831,783,48,42,254,0.0
2089.8,833,785,48,42,254,0.0
2102.58,833,787,46,43,255,0.0
2115.19,834,786,48,43,255,0.0
2128.01,833,787,46,43,254,0.0
2140.58,829,780,49,43,253,0.0
2154.33,830,782,48,42,254,0.0
2167.86,834,785,49,42,255,0.0
2180.32,832,781,51,42,253,0.0
2193.87,834,784,50,43,255,0.0
2206.39,829,780,49,43,254,0.0
2218.97,839,786,53,43,255,0.0
2231.49,834,785,49,43,255,-0.0333
2243.89,832,782,50,42,254,0.0
2257.6,835,786,49,42,255,0.0
2270.12,832,784,48,41,254,0.0
2282.69,833,786,47,42,255,0.0
2295.26,834,786,48,42,254,0.0
2307.76,831,782,49,42,254,0.0
2320.83,834,786,48,41,254,0.0
2333.32,831,781,50,42,253,0.0
2346.13,831,791,40,42,255,0.0
2358.62,831,783,48,42,254,0.0
2371.02,831,783,48,41,254,0.0
2383.88,833,785,48,42,255,0.0
2396.43,830,783,47,42,254,0.0
2409.36,835,784,51,42,255,0.0
2421.85,831,782,49,42,253,0.0
2434.3,827,780,47,42,252,0.0
2447.73,835,785,50,42,254,0.0
2460.2,831,783,48,44,254,0.0
2473.51,831,782,49,42,254,0.0
2486.1,831,783,48,42,254,0.0
2498.68,834,785,49,42,254,0.0
2511.73,833,786,47,41,255,0.0
2524.12,833,782,51,41,253,0.0
2537.71,834,784,50,42,255,0.0
2550.2,830,782,48,42,254,0.0
2562.78,835,781,54,42,254,0.0333
2575.34,834,785,49,42,255,0.0
2587.75,830,783,47,42,254,0.0
2600.68,834,786,48,42,255,0.0
2613.19,832,781,51,43,254,0.0
2626.01,834,786,48,41,255,0.0
2638.48,831,783,48,42,254,0.0
2650.82,829,784,45,42,254,0.0
2663.66,833,784,49,42,255,0.0
2676.14,831,784,47,42,253,0.0
2688.81,834,787,47,42,255,0.0
2701.36,829,784,45,42,254,0.0
2713.78,832,781,51,42,253,0.0
2726.62,833,786,47,41,255,0.0
2739.12,832,783,49,43,253,0.0
2754.48,832,784,48,42,254,0.0
2770.94,830,781,49,43,254,0.0
2784.2,835,785,50,42,255,0.0
2796.82,835,781,54,43,255,0.0
2809.41,831,782,49,43,253,0.0
2822.59,836,785,51,42,254,0.0
2835.51,831,782,49,43,253,0.0
2848.96,834,782,52,43,255,0.0
2861.5,830,783,47,42,254,0.0
2874.04,835,785,50,43,255,0.0
2886.66,834,787,47,43,255,0.0
2898.98,833,782,51,41,253,0.0
2912.5,834,785,49,41,254,0.0
2925.07,829,781,48,42,253,0.0
2938.08,833,786,47,42,254,-0.0333
2950.6,833,786,47,43,254,0.0
2963.1,830,783,47,42,253,0.0
2976.16,834,782,52,40,256,0.0
2988.72,829,783,46,42,254,0.0
3001.54,834,787,47,42,255,0.0
3014.11,831,784,47,42,254,0.0
3026.63,831,783,48,43,253,0.0
3039.7,834,785,49,42,255,0.0
3052.63,831,782,49,43,254,0.0
3066.41,830,786,44,42,255,0.0
3079.34,829,782,47,42,254,0.0
3092.62,834,786,48,42,255,0.0
3105.4,835,786,49,42,255,0.0
3117.77,831,783,48,43,253,0.0
3131.23,834,785,49,42,255,0.0
3143.8,831,783,48,42,254,0.0
3156.45,834,786,48,42,254,0.0
3169.32,833,787,46,42,254,0.0
3181.76,831,783,48,43,254,0.0
3194.81,831,785,46,42,254,0.0
3207.41,830,783,47,42,254,-0.0333
3220.39,835,786,49,42,254,0.0
3232.9,831,784,47,42,254,0.0
3245.4,831,782,49,42,254,0.0
3258.35,834,786,48,42,254,0.0
3270.96,831,782,49,42,253,0.0
3284.2,835,785,50,42,255,0.0
3296.84,832,782,50,41,254,0.0
3309.46,832,781,51,42,253,0.0
3322.74,833,785,48,43,255,0.0
3335.18,830,783,47,43,255,0.0
3348.81,832,785,47,42,254,-0.0333
3361.97,830,783,47,42,253,0.0
3374.94,831,783,48,43,254,0.0
3387.74,831,783,48,43,254,0.0
3401.4,829,781,48,42,253,0.0
3414.96,822,777,45,42,252,0.0
3427.77,824,780,44,42,252,0.0
3440.5,823,780,43,41,252,0.0
3452.48,819,776,43,41,252,0.0
3464.57,824,781,43,43,253,-0.0333
3477.52,827,783,44,42,254,0.0
3489.45,823,779,44,41,252,0.0
3502.19,828,784,44,42,255,-0.0333
3514.14,824,779,45,42,252,0.0
3526.15,826,784,42,41,254,0.0
3538.07,829,783,46,42,254,0.0
3549.78,824,781,43,40,253,0.0
3562.82,828,784,44,41,254,0.0
3574.74,823,779,44,41,253,0.0
3586.69,827,784,43,41,254,0.0
3598.63,828,783,45,42,254,0.0
3610.34,823,780,43,41,252,0.0
3623.16,828,784,44,41,256,0.0
3635.18,828,784,44,41,254,0.0
3646.95,824,779,45,41,254,0.0
3659.53,831,784,47,41,254,0.0
3671.32,824,780,44,41,253,0.0
3683.36,828,784,44,42,254,0.0
3695.43,827,786,41,41,253,0.0
3707.24,822,780,42,42,253,0.0
3719.52,828,784,44,40,254,0.0
3731.45,826,780,46,42,252,0.0
3743.43,823,779,44,41,252,0.0
3755.68,827,784,43,41,254,0.0
3767.72,818,783,35,41,253,0.0
3780.72,827,785,42,42,254,0.0
3792.62,823,780,43,42,252,0.0
3804.57,827,781,46,41,252,0.0
3816.47,829,784,45,41,255,-0.0333
3828.19,824,780,44,43,253,0.0
3840.88,829,784,45,42,254,0.0
3852.82,824,780,44,41,253,0.0
3864.86,829,783,46,41,254,0.0
3877.02,832,784,48,43,254,0.0
3888.75,823,779,44,41,252,0.0
3901.31,826,784,42,42,254,0.0
3913.24,828,784,44,41,254,0.0
3924.98,824,780,44,42,253,0.0333
3937.83,826,784,42,41,254,0.0
3949.67,824,780,44,42,253,0.0
3961.76,827,784,43,42,254,0.0
3973.68,828,784,44,42,254,0.0
3985.44,823,780,43,41,253,0.0
3997.64,827,784,43,41,254,0.0
4009.56,823,779,44,41,253,-0.0333
4021.53,827,784,43,41,254,0.0
4033.42,828,784,44,42,254,0.0
4045.21,825,781,44,43,253,0.0
4058.21,828,784,44,42,254,0.0333
4070.16,824,781,43,42,253,0.0
4082.06,826,785,41,43,255,0.0
4094.03,827,784,43,42,254,0.0
4105.81,825,779,46,42,253,0.0
4118.74,825,782,43,42,254,0.0
4130.75,833,784,49,42,254,-0.0333
4143.55,832,783,49,42,253,0.0
4156.7,834,785,49,42,254,0.0
4169.53,832,783,49,42,254,0.0
4183.0,833,785,48,42,255,0.0
4195.88,833,784,49,42,254,0.0
4208.77,832,784,48,42,254,0.0
4222.46,835,786,49,42,254,0.0
4235.1,833,779,54,43,255,0.0
4248.12,836,786,50,42,255,0.0
4260.68,830,783,47,41,254,0.0
4273.56,831,785,46,42,255,0.0
4286.19,832,783,49,42,254,0.0
4298.6,831,783,48,41,254,0.0
4311.62,834,786,48,42,255,0.0
4324.27,832,782,50,42,255,0.0
4337.56,834,786,48,41,254,0.0
4350.11,831,783,48,42,254,0.0
4362.74,831,782,49,41,254,0.0
4376.12,833,786,47,42,255,0.0
4388.56,831,782,49,42,253,0.0
4402.27,835,786,49,42,255,0.0
4414.93,831,778,53,43,254,0.0
4427.56,831,783,48,42,254,0.0
4440.46,832,783,49,42,254,0.0
4453.21,832,783,49,42,254,0.0
4466.2,834,785,49,42,255,0.0
4478.76,829,783,46,42,254,0.0
4491.64,835,785,50,42,255,0.0
4504.22,831,783,48,42,253,0.0
4516.67,831,782,49,42,254,0.0
4529.74,835,786,49,42,254,-0.0333
4542.32,831,781,50,41,254,0.0
4555.5,832,782,50,42,254,0.0
4569.07,831,783,48,43,254,0.0
4581.73,834,786,48,41,254,0.0
4594.6,833,785,48,42,255,0.0
4607.05,831,783,48,41,254,0.0
4620.53,835,784,51,42,255,0.0
4633.08,832,783,49,42,254,0.0
4645.82,832,786,46,42,254,0.0
4658.38,833,785,48,42,255,0.0
4670.85,832,783,49,41,254,0.0
4683.82,833,787,46,42,254,0.0
4696.44,828,780,48,42,253,0.0
4711.5,834,785,49,41,255,0.0
4724.85,829,781,48,42,253,0.0
4737.52,834,785,49,42,255,0.0
4750.45,834,786,48,42,255,0.0
4762.92,834,784,50,43,254,0.0
4775.66,831,787,44,41,255,0.0
4788.17,829,780,49,42,253,0.0
4800.79,835,787,48,42,254,0.0333
4813.37,832,786,46,43,255,0.0
4825.76,833,784,49,42,255,0.0
4838.38,834,785,49,43,254,0.0
4850.73,830,782,48,41,253,0.0333
4863.12,832,785,47,42,254,0.0
4875.53,833,785,48,43,255,0.0
4887.68,833,784,49,43,254,0.0
4900.33,833,784,49,42,254,0.0
4912.67,830,782,48,43,254,0.0
4925.07,833,784,49,41,255,0.0
4937.38,829,786,43,41,254,0.0
4949.44,832,785,47,42,254,0.0
4962.3,833,784,49,42,254,0.0
4974.65,829,782,47,42,253,0.0
4987.1,834,785,49,42,254,0.0
4999.42,833,786,47,41,254,0.0
5011.57,833,784,49,43,254,0.0
5024.31,833,786,47,42,254,0.0
5040.55,830,782,48,43,253,0.0
5055.25,834,784,50,43,255,0.0
5067.76,831,783,48,42,254,0.0
5080.38,831,786,45,42,254,-0.0333
5093.01,834,785,49,43,255,0.0
5105.43,830,783,47,42,254,0.0
5121.96,833,786,47,42,255,0.0
5134.55,831,783,48,43,252,0.0
5147.8,833,786,47,42,254,0.0
5160.3,831,783,48,41,254,0.0
5172.9,829,782,47,42,255,-0.0333
5186.33,833,786,47,42,254,0.0
5198.74,832,783,49,42,254,0.0
5212.47,834,785,49,42,255,0.0
5225.11,831,778,53,41,254,0.0
5237.71,835,786,49,42,254,0.0
5250.27,835,787,48,42,254,0.0
5262.66,829,782,47,42,253,0.0
5276.16,836,786,50,41,255,0.0333
5288.73,834,783,51,42,254,0.0
5301.34,835,786,49,42,255,0.0
5313.91,834,785,49,42,255,0.0
5326.26,831,783,48,41,254,0.0
5339.51,833,786,47,41,255,0.0
5352.64,825,784,41,41,254,0.0
5365.57,834,787,47,42,254,0.0333
5378.16,831,783,48,43,254,0.0333
5390.76,831,783,48,42,254,0.0
5404.71,833,786,47,43,255,0.0
5417.18,831,780,51,42,254,0.0
5430.9,834,785,49,41,255,-0.0333
5443.48,831,783,48,42,254,-0.0333
5456.13,834,783,51,42,254,0.0
5469.04,834,785,49,43,255,0.0
5481.51,832,783,49,42,254,0.0
5494.55,833,784,49,43,254,0.0
5507.14,831,781,50,42,254,0.0
5520.05,834,785,49,44,255,0.0
5532.64,833,782,51,41,255,0.0
5545.21,831,783,48,42,253,0.0333
5558.53,835,786,49,42,255,0.0
5571.13,831,780,51,42,253,0.0
5584.33,834,787,47,43,255,-0.0333
5596.92,831,783,48,44,254,0.0
5609.54,829,783,46,42,254,0.0
5622.89,831,785,46,43,253,0.0
5635.69,832,783,49,42,254,0.0
5649.19,836,786,50,42,255,0.0
5661.77,832,783,49,42,254,0.0
5674.44,835,785,50,42,255,0.0
5687.27,835,786,49,42,254,0.0
5699.64,832,782,50,42,254,0.0
5712.67,836,781,55,42,255,0.0
5725.27,829,782,47,42,253,0.0
5738.14,835,786,49,42,255,0.0
5750.69,831,783,48,43,254,0.0
5763.2,830,782,48,42,254,0.0
5776.3,834,785,49,42,255,0.0
5788.87,830,782,48,42,253,0.0
5802.74,834,784,50,42,255,0.0
5815.42,832,782,50,42,254,0.0
5828.53,829,780,49,43,253,0.0
5841.83,835,786,49,42,255,0.0
5854.88,831,783,48,41,253,0.0
5868.3,834,787,47,42,255,0.0
5880.93,830,782,48,42,254,0.0
5893.58,835,787,48,42,255,0.0
5906.15,835,786,49,43,255,0.0
5918.56,831,783,48,41,254,0.0
5931.53,833,786,47,42,255,0.0
5944.11,830,783,47,42,254,0.0
5957.05,832,786,46,43,255,0.0
5969.97,832,784,48,42,254,0.0
5982.52,830,781,49,42,253,0.0
5996.07,830,786,44,43,255,0.0
6008.82,832,783,49,42,254,0.0
6022.36,834,784,50,42,255,0.0
6035.34,830,790,40,42,254,0.0
6047.97,834,787,47,43,255,0.0
6060.59,834,786,48,43,255,0.0
6073.06,831,783,48,42,253,0.0
6086.5,835,787,48,44,255,0.0
6099.09,831,782,49,42,254,0.0
6112.02,834,786,48,43,254,0.0
6124.61,832,783,49,42,254,0.0
6137.12,831,783,48,41,253,0.0
6150.22,835,785,50,41,254,0.0
6162.81,831,782,49,42,254,0.0
6176.16,835,786,49,41,255,0.0333
6188.71,832,783,49,42,254,0.0
6201.3,832,784,48,42,255,0.0333
6214.64,836,786,50,42,254,0.0
6227.17,832,782,50,43,254,0.0333
6240.81,834,786,48,43,254,0.0333
6253.43,832,784,48,42,254,0.0333
6266.08,834,785,49,42,255,-0.0333
6278.7,834,785,49,43,254,0.0
6291.12,831,783,48,42,253,0.0
6305.28,835,785,50,41,254,0.0
6317.86,830,783,47,42,254,0.0
6330.75,835,786,49,41,255,0.0
6343.37,832,783,49,42,253,0.0
6355.89,831,783,48,42,253,0.0
6369.77,835,786,49,42,255,0.0
6382.37,831,783,48,43,254,0.0
6395.82,835,783,52,42,255,0.0
6408.5,831,782,49,42,253,0.0
6421.17,833,785,48,42,254,0.0
6434.01,834,785,49,42,255,0.0
6446.51,831,781,50,43,254,0.0
6460.0,834,785,49,42,255,0.0
6472.56,832,783,49,42,254,0.0
6485.28,843,786,57,43,256,0.0
6498.24,830,780,50,42,254,0.0
6511.37,831,782,49,42,253,-0.0333
6524.25,834,786,48,42,255,0.0
6537.21,831,783,48,43,253,0.0
6550.45,834,785,49,42,255,0.0
6563.07,831,780,51,42,253,0.0333
6575.76,832,784,48,42,254,0.0
6589.03,834,785,49,43,255,0.0
6601.45,830,783,47,43,254,0.0
6615.21,834,786,48,42,255,0.0
6628.06,830,783,47,41,254,0.0
6640.7,834,786,48,41,255,0.0
6653.53,834,787,47,43,254,0.0333
6665.97,831,783,48,43,254,0.0
6679.44,835,785,50,41,255,0.0
6692.36,828,780,48,41,253,0.0
6707.61,832,783,49,42,254,-0.0333
6721.71,828,779,49,41,253,0.0
6735.85,828,781,47,42,253,0.0
6748.86,826,780,46,42,253,0.0
6761.56,830,782,48,41,254,0.0
6774.21,830,784,46,41,253,0.0
6786.72,831,784,47,42,253,0.0
6799.17,829,782,47,42,253,0.0
6813.12,828,782,46,42,254,0.0
6825.69,830,785,45,42,254,0.0
6838.69,834,784,50,43,254,0.0
6850.85,824,780,44,42,253,0.0
6863.61,828,784,44,41,254,0.0
6875.53,823,780,43,42,253,0.0
6887.45,828,785,43,42,254,0.0
6899.31,829,783,46,42,255,0.0
6911.0,825,780,45,42,253,0.0
6923.6,826,780,46,42,252,0.0
6935.56,828,785,43,40,251,0.0
6947.36,825,782,43,41,255,0.0333
6959.8,828,785,43,41,254,0.0
6971.53,826,781,45,42,253,0.0
6983.94,828,784,44,42,254,0.0
6995.83,829,784,45,42,254,0.0
7007.56,819,777,42,41,252,0.0
7020.07,827,785,42,42,254,0.0
7031.94,825,780,45,42,252,0.0
7043.82,826,784,42,41,253,0.0
7055.7,828,783,45,42,254,0.0
7067.4,825,781,44,42,253,0.0
7080.35,825,786,39,43,255,0.0
7092.23,823,780,43,41,253,0.0
7104.14,827,785,42,41,254,0.0
7116.08,827,785,42,42,254,0.0
7127.77,823,779,44,42,252,0.0
7140.14,826,780,46,42,252,0.0
7152.06,828,778,50,42,255,0.0
7163.76,824,780,44,42,253,0.0
7176.7,823,780,43,41,252,0.0
7188.75,825,784,41,42,255,0.0
7200.74,827,785,42,42,254,0.0
7212.63,828,784,44,42,254,0.0
7224.46,824,780,44,42,253,0.0
7236.97,826,783,43,41,254,0.0
7248.83,825,780,45,41,253,0.0
7260.75,829,787,42,43,255,0.0
7272.64,828,783,45,42,254,0.0333
7284.27,823,777,46,42,252,0.0
7297.04,828,790,38,42,254,0.0
7308.9,828,784,44,42,253,0.0
7320.7,828,784,44,42,255,0.0
7332.94,829,779,50,43,256,0.0333
7344.67,824,779,45,41,253,0.0
7357.09,828,784,44,42,254,0.0
7368.98,828,783,45,42,254,0.0
7380.65,823,779,44,41,253,0.0333
7393.42,827,784,43,42,253,0.0333
7405.25,820,781,39,41,253,0.0333
7417.23,827,784,43,41,254,0.0333
7429.12,829,784,45,42,254,0.0333
7440.88,827,780,47,42,253,0.0333
7453.06,827,784,43,41,254,0.0333
7464.95,822,780,42,42,253,0.0333
7476.88,828,787,41,42,254,0.0333
7488.77,829,783,46,42,254,0.0333
7500.39,824,779,45,42,254,0.0333
7513.18,827,783,44,41,252,0.0333
7525.11,829,783,46,42,252,0.0333
7536.91,829,784,45,42,255,0.0667
7549.25,824,784,40,42,254,0.0667
7560.99,831,783,48,42,253,0.0667
7573.57,833,786,47,42,255,0.0333
7586.11,836,786,50,42,255,0.0667
7598.45,834,783,51,41,253,0.0667
7611.39,834,786,48,41,255,0.1
7623.9,832,781,51,41,254,0.1
7636.67,835,786,49,42,255,0.1
7649.13,830,784,46,41,253,0.1
7661.57,831,783,48,42,253,0.1333
7674.44,827,787,40,41,254,0.1667
7687.0,830,783,47,43,253,0.2
7699.89,835,787,48,42,255,0.2
7712.42,831,782,49,41,254,0.2333
7725.05,831,781,50,42,252,0.2333
7738.25,834,784,50,43,255,0.3
7750.83,832,783,49,42,254,0.3333
7764.23,835,784,51,41,255,0.3667
7776.87,831,783,48,41,254,0.4
7789.54,833,783,50,42,254,0.4333
7802.44,834,786,48,43,254,0.4333
7814.89,830,783,47,42,254,0.4
7828.54,835,786,49,42,255,0.4
7841.11,831,783,48,42,255,0.4333
7853.81,831,791,40,41,254,0.4667
7866.58,834,786,48,41,255,0.5
7879.54,831,783,48,43,254,0.5
7892.4,834,784,50,42,255,0.5
7904.99,831,782,49,43,254,0.5
7917.76,835,784,51,42,254,0.4667
7930.33,830,783,47,42,254,0.4667
7942.82,831,777,54,40,253,0.4667
7955.7,834,787,47,42,255,0.4667
7968.31,830,781,49,43,254,0.4667
7981.51,835,786,49,43,255,0.4
7994.09,831,783,48,42,253,0.2667
8006.79,832,783,49,41,254,0.2333
8020.28,831,787,44,41,255,0.1667
8032.71,832,782,50,43,254,0.2
8046.4,835,787,48,42,255,0.2333
8058.96,831,783,48,42,254,0.2667
8071.55,835,784,51,42,255,0.2667
8084.12,834,785,49,43,255,0.2667
8096.6,831,783,48,42,253,0.2667
8110.06,835,786,49,43,255,0.2667
8122.65,831,783,48,42,252,0.2667
8135.35,836,785,51,41,255,0.2667
8147.91,834,787,47,43,254,0.2667
8160.29,831,783,48,42,254,0.2333
8173.63,836,784,52,42,254,0.2667
8186.25,832,781,51,42,254,0.2667
8199.07,833,786,47,42,254,0.2667
8211.64,832,783,49,42,254,0.2667
8224.1,832,783,49,42,254,0.2667
8236.98,834,786,48,43,254,0.2667
8249.53,832,780,52,43,255,0.2667
8262.69,834,785,49,42,254,0.2667
8275.32,831,782,49,41,254,0.2667
8287.98,831,783,48,42,253,0.2667
8301.22,835,786,49,42,255,0.2667
8313.73,832,781,51,43,253,0.2667
8327.48,834,786,48,42,255,0.2667
8340.05,839,783,56,42,253,0.2667
8352.76,832,786,46,42,255,0.3
8366.08,835,785,50,43,254,0.3
8378.56,832,782,50,42,254,0.2667
8392.07,834,787,47,42,254,0.3
8404.67,831,784,47,42,254,0.2667
8417.31,835,786,49,41,255,0.3
8429.87,833,780,53,42,254,0.3
8442.27,831,783,48,42,253,0.3333
8455.48,835,785,50,42,255,0.3333
8468.06,831,780,51,42,253,0.3667
8480.91,833,786,47,42,254,0.4333
8493.47,831,783,48,42,254,0.5
8505.98,830,782,48,42,253,0.6333
8518.98,840,787,53,42,255,0.7333
8531.58,830,782,48,43,254,0.8
8545.17,830,782,48,43,254,0.9
8557.94,831,783,48,43,254,1.0
8571.57,835,786,49,43,255,1.1667
8584.67,835,786,49,42,255,1.3667
8597.14,831,783,48,42,254,1.5333
8610.64,834,783,51,41,255,1.6333
8623.21,832,783,49,42,255,1.6667
8636.02,835,785,50,42,255,1.6667
8648.73,834,785,49,43,254,1.7
8661.36,831,783,48,43,254,1.7667
8674.33,834,784,50,41,255,1.9333
8686.92,833,786,47,43,255,2.1333
8699.54,832,784,48,43,253,2.3333
8712.08,831,783,48,43,254,2.4667
8724.56,831,782,49,43,254,2.5333
8737.42,834,784,50,43,253,2.5667
8750.04,831,782,49,42,253,2.6
8763.06,834,784,50,43,255,2.7333
8775.7,834,784,50,42,255,2.7
8788.26,831,782,49,42,254,2.6333
8801.08,836,787,49,42,255,2.6
8813.67,832,781,51,42,253,2.5667
8827.02,835,786,49,42,254,2.6
8839.62,835,785,50,43,254,2.6
8852.29,831,782,49,43,254,2.5667
8865.92,833,786,47,42,255,2.4667
8878.56,827,782,45,41,254,2.3333
8891.65,834,785,49,42,255,2.2
8904.29,835,785,50,42,255,2.1333
8916.96,832,786,46,42,255,2.0667
8929.55,834,785,49,42,254,2.0667
8942.1,831,782,49,42,254,2.0667
8955.17,834,785,49,41,255,2.0667
8967.77,834,786,48,43,255,2.0667
8980.44,835,786,49,43,255,2.2333
8993.05,833,785,48,43,253,2.6
9005.64,831,783,48,43,252,2.8
9018.58,834,787,47,43,255,2.8667
9031.2,837,785,52,42,255,2.9
9043.89,834,787,47,43,255,2.8667
9056.46,831,786,45,43,255,2.9
9068.95,832,783,49,43,254,2.8667
9081.87,834,784,50,43,255,2.9
9094.48,833,785,48,42,254,2.9333
9107.18,832,785,47,42,255,2.9667
9119.82,831,783,48,44,255,2.9
9132.32,831,782,49,42,253,3.0
9145.51,835,786,49,42,255,2.9667
9158.11,835,785,50,43,255,2.9333
9170.84,833,785,48,42,255,3.0667
9183.41,832,783,49,43,254,3.2
9196.02,831,782,49,42,254,3.2667
9208.9,834,783,51,43,255,3.3333
9221.5,827,777,50,44,255,3.5333
9234.46,834,786,48,43,254,5.0
9247.26,833,786,47,44,254,5.0667
9259.94,831,783,48,42,253,5.3
9273.25,835,786,49,43,254,5.3
9285.73,829,782,47,43,254,5.3667
9299.14,835,784,51,43,254,5.4667
9311.57,831,787,44,43,253,5.5333
9324.13,833,786,47,43,254,5.5333
9336.69,833,785,48,43,255,5.5
9348.87,830,782,48,43,253,5.6667
9362.02,834,784,50,44,254,5.7667
9374.45,835,785,50,44,254,5.8
9387.27,835,785,50,43,255,5.9
9400.02,832,785,47,43,254,5.9333
9412.55,831,783,48,45,254,6.1333
9425.71,835,785,50,44,255,6.3667
9438.31,834,785,49,44,254,6.5333
9450.99,834,786,48,44,254,6.7
9463.59,835,784,51,45,255,6.8667
9476.14,831,783,48,44,254,7.0667
9489.19,834,786,48,45,254,7.3333
9501.81,832,783,49,45,254,7.6667
9514.57,835,786,49,45,254,7.8667
9527.11,827,789,38,45,253,8.0667
9539.58,830,783,47,44,253,8.2667
9552.44,834,784,50,46,254,8.4333
9565.03,828,780,48,46,254,8.6667
9578.04,834,786,48,46,255,8.9667
9590.56,832,783,49,45,254,9.1667
9603.14,831,782,49,45,252,9.3667
9616.38,834,786,48,46,255,9.7
9628.93,830,783,47,47,254,9.9
9642.19,835,784,51,48,254,10.0
9654.77,832,783,49,46,254,10.1667
9667.28,831,783,48,48,254,10.3667
9680.58,832,785,47,48,254,10.7333
9693.02,832,781,51,47,253,10.8
9706.71,835,784,51,49,251,10.7
9719.3,830,783,47,49,254,10.8667
9731.88,835,786,49,48,255,10.9333
9744.43,834,780,54,47,254,11.1333
9756.9,829,780,49,47,253,11.1667
9770.13,835,786,49,48,255,11.1
9782.66,832,783,49,48,253,11.2
9795.49,834,786,48,47,255,11.2
9808.04,831,783,48,47,254,11.1
9820.56,831,783,48,50,254,11.2667
9833.88,837,784,53,49,256,11.4
9846.45,829,781,48,48,252,11.4667
9859.61,831,784,47,50,253,11.5
9872.4,825,780,45,48,253,11.4667
9886.27,831,782,49,49,254,11.7
9898.89,831,783,48,50,253,11.5667
9912.28,831,783,48,50,254,11.8
9924.75,829,781,48,47,252,11.7333
9937.4,832,783,49,49,254,11.8
9951.17,833,784,49,49,254,11.9333
9964.54,837,785,52,49,255,12.0333
9977.36,823,780,43,48,253,12.0667
9989.68,827,785,42,49,254,12.1333
10001.78,824,781,43,49,253,12.3
10014.95,828,784,44,48,255,12.2667
10026.86,825,780,45,48,253,12.3667
10038.82,828,784,44,50,254,12.3667
10050.77,825,784,41,48,254,12.4333
10062.49,824,779,45,50,253,12.5333
10075.53,827,783,44,49,254,12.6667
10087.48,827,785,42,49,253,12.6333
10099.21,825,781,44,51,255,12.8667
10111.81,828,783,45,50,255,12.7667
10123.58,823,778,45,52,253,12.8333
10135.98,828,784,44,50,254,13.0333
10147.91,829,783,46,51,254,13.2
10159.65,821,776,45,50,252,13.2333
10172.34,827,785,42,50,255,13.3667
10184.26,824,780,44,50,253,13.4
10196.35,828,784,44,52,255,13.4333
10208.28,829,785,44,52,255,13.6
10220.11,825,780,45,52,253,13.7667
10232.29,826,784,42,52,254,14.0333
10244.21,823,779,44,53,253,14.0
10256.2,828,784,44,53,254,14.0333
10268.13,827,782,45,52,254,14.2
10279.92,825,781,44,54,253,14.4333
10292.95,827,785,42,53,254,14.6
10304.93,824,781,43,52,253,14.5333
10316.83,827,785,42,54,254,14.7
10328.79,829,784,45,54,254,14.9
10340.59,823,777,46,53,252,14.8667
10353.57,829,784,45,54,255,15.1667
10365.51,827,782,45,53,252,15.0
10377.34,828,784,44,54,254,15.2333
10389.84,829,784,45,55,255,15.2333
10401.55,824,780,44,54,253,15.3667
10414.01,828,784,44,54,254,15.4
10425.96,829,784,45,54,254,15.4333
10437.72,823,777,46,54,252,15.5667
10450.4,827,785,42,54,253,15.7667
10462.32,824,780,44,54,253,15.7667
10474.39,828,784,44,53,255,15.7
10486.37,828,784,44,54,255,15.7667
10498.14,823,779,44,54,253,15.7667
10510.31,828,784,44,54,254,15.6333
10522.24,824,780,44,54,253,15.8
10534.2,828,784,44,56,254,15.8
10546.19,828,783,45,55,254,15.7667
10557.97,825,781,44,56,253,15.6667
10571.05,828,784,44,55,254,15.7667
10582.93,822,780,42,54,253,15.8333
10594.91,826,784,42,55,254,15.8667
10606.87,827,783,44,55,255,15.7667
10618.54,824,779,45,55,253,15.8333
10631.18,826,784,42,55,254,15.8333
10643.11,829,782,47,56,254,15.9
10654.89,824,780,44,54,253,16.0667
10667.51,829,784,45,55,254,16.1667
10679.32,824,779,45,56,252,16.3333
10692.02,835,786,49,55,255,16.2
10704.91,833,783,50,57,253,16.1667
10717.84,832,783,49,57,254,16.2667
10731.05,836,786,50,57,254,16.3667
10743.84,832,783,49,55,254,16.3
10757.3,837,787,50,55,255,16.4
10770.12,832,785,47,58,256,16.4333
10782.88,830,782,48,57,253,16.7667
10796.51,833,784,49,58,254,16.3667
10809.37,831,783,48,57,253,16.6
10822.41,835,786,49,56,255,16.5667
10835.1,831,783,48,57,253,16.6333
10847.94,832,786,46,57,255,16.5333
10860.52,826,783,43,57,253,16.5333
10872.99,831,782,49,57,254,16.6667
10886.85,834,787,47,56,254,16.7
10899.39,833,783,50,58,254,16.7333
10912.78,833,786,47,57,253,16.5
10925.39,832,783,49,57,254,16.7
10938.03,833,786,47,58,254,16.6667
10951.12,839,785,54,56,255,16.6667
10963.63,832,783,49,57,253,16.7667
10977.24,835,786,49,57,255,16.9333
10989.8,830,783,47,56,253,16.8
11002.78,832,785,47,56,253,16.8333
11015.36,835,785,50,56,255,16.8
11027.83,830,782,48,57,253,16.9667
11041.04,835,785,50,57,255,17.0333
11053.67,832,783,49,57,254,16.8333
11066.41,834,785,49,56,255,16.8667
11079.0,831,783,48,56,253,16.8
11091.88,830,783,47,57,254,16.7333
11105.02,834,786,48,58,254,16.8333
11117.59,831,782,49,57,254,16.8
11130.67,834,784,50,58,255,17.0
11143.24,830,781,49,58,254,16.7333
11155.86,829,780,49,58,254,16.7667
11169.72,835,784,51,57,255,16.8667
11182.3,831,781,50,55,254,17.0
11196.06,835,785,50,56,255,16.6667
11208.62,831,782,49,58,254,16.9
11221.3,833,786,47,58,255,16.7667
11234.02,835,784,51,58,255,16.8667
11246.51,832,783,49,57,253,16.8667
11259.69,834,786,48,58,255,16.8667
11272.26,832,781,51,56,254,16.9
11285.1,834,785,49,58,255,16.9
11298.14,829,780,49,57,253,16.8333
11311.36,831,782,49,56,253,16.8333
11324.52,835,786,49,58,255,17.2333
11337.21,832,783,49,57,253,16.9667
11350.58,833,786,47,58,255,16.9
11363.2,831,782,49,56,253,16.8667
11375.97,835,786,49,58,255,16.8
11388.94,834,786,48,59,254,16.7333
11401.34,832,783,49,56,254,17.2333
11415.01,835,784,51,58,254,16.7
11427.57,831,783,48,57,253,16.9
11440.2,835,785,50,58,255,17.0333
11453.0,833,786,47,58,256,16.9333
11465.32,830,783,47,56,254,16.8667
11478.57,835,785,50,58,255,17.0333
11491.13,829,784,45,57,254,16.8
11504.15,834,786,48,58,255,16.9667
11516.76,832,783,49,56,255,16.8667
11529.36,830,780,50,57,253,16.9333
11542.73,834,785,49,57,256,16.9667
11555.29,832,782,50,58,254,16.9667
11568.68,835,786,49,56,255,17.1333
11581.27,831,782,49,59,254,16.8667
11593.99,833,786,47,58,255,16.8
11607.05,834,785,49,57,255,16.8333
11619.79,832,782,50,57,254,16.8667
11633.3,833,785,48,56,255,16.7
11645.96,831,783,48,58,254,16.8
11658.83,834,786,48,58,254,16.9333
11671.37,835,785,50,58,255,17.1333
11683.78,832,783,49,58,254,17.0
11697.04,835,785,50,57,255,16.9667
11709.59,833,781,52,57,255,16.9
11722.41,836,786,50,57,255,17.0667
11735.38,831,783,48,57,253,17.0333
11747.99,828,780,48,58,253,16.9
11761.33,835,785,50,58,255,17.0667
11773.9,830,783,47,58,254,17.1
11788.29,835,785,50,56,255,17.1333
11800.85,832,783,49,58,254,17.0667
11813.56,830,791,39,58,254,17.0667
11826.34,831,785,46,57,254,17.0333
11838.88,832,783,49,57,254,17.1
11852.34,834,785,49,58,254,17.1
11864.95,828,781,47,58,254,17.0
11877.77,833,786,47,57,254,17.1667
11890.33,833,783,50,58,254,17.2
11903.03,829,784,45,57,253,17.4333
11915.88,834,786,48,58,255,17.5333
11928.45,831,783,48,59,253,17.4
11941.49,834,784,50,57,255,17.3667
11954.19,832,783,49,59,253,17.4333
11966.77,832,783,49,57,254,17.3667
11981.66,832,786,46,59,254,17.3
11994.8,831,783,48,59,254,17.3
12007.87,833,786,47,59,255,17.4
12020.47,832,781,51,59,254,17.3333
12033.27,832,785,47,59,255,17.2667
12045.93,831,783,48,59,254,17.5
12058.8,831,783,48,58,253,17.6
12071.91,835,784,51,61,254,17.5333
12084.5,832,783,49,60,254,17.6667
12097.6,835,787,48,60,254,17.6667
12110.18,831,783,48,60,254,17.8333
12122.82,833,781,52,60,255,17.8
12136.67,835,786,49,59,255,17.6333
12149.14,832,783,49,60,254,18.0
12162.71,835,785,50,60,254,17.8667
12175.32,831,783,48,60,253,17.9
12187.95,835,787,48,60,255,17.6
12200.52,834,785,49,60,255,17.7667
12213.02,830,783,47,60,254,18.0667
12226.17,835,787,48,61,254,17.9333
12238.75,832,782,50,60,254,18.0
12251.54,835,784,51,60,255,17.7667
12264.13,838,784,54,59,254,18.0333
12276.66,831,783,48,61,253,18.3333
12289.46,835,786,49,61,255,18.4667
12302.46,832,782,50,60,254,18.4
12315.72,835,786,49,59,255,18.5667
12328.3,830,783,47,61,254,18.5667
12340.95,834,786,48,61,255,18.5
12356.72,833,784,49,62,254,18.5333
12369.67,832,784,48,61,254,18.6333
12382.48,835,786,49,62,254,18.6333
12395.07,832,783,49,61,253,18.7667
12407.83,835,783,52,62,254,18.8667
12420.4,832,783,49,62,254,18.8667
12432.8,831,782,49,62,254,19.0
12445.64,834,785,49,61,255,18.9333
12458.21,830,782,48,63,253,19.2
12471.78,836,784,52,61,255,19.0333
12484.33,832,783,49,62,254,19.2667
12496.97,833,777,56,64,253,19.2
12510.49,835,785,50,63,255,19.3
12523.0,831,783,48,64,253,19.5333
12537.49,835,785,50,63,254,19.4
12550.04,832,783,49,64,254,19.3667
12562.7,833,785,48,64,255,19.5333
12575.32,835,785,50,64,255,19.5
12587.85,832,782,50,63,254,19.6667
12600.8,834,786,48,63,255,19.6333
12613.41,831,781,50,65,254,19.9
12626.3,835,785,50,65,255,19.8
12638.83,831,783,48,65,254,19.6333
12651.26,831,784,47,66,253,19.7333
12664.89,831,780,51,65,255,19.6667
12677.79,831,782,49,65,253,19.8333
12691.05,836,785,51,65,255,19.7667
12703.62,832,783,49,63,254,19.5333
12716.12,833,785,48,64,255,20.5667
12728.62,833,786,47,65,255,20.2333
12741.0,832,783,49,64,254,19.8667
12754.16,835,786,49,64,255,20.1
12766.74,830,783,47,66,252,20.1333
12779.29,833,785,48,64,255,20.0333
12791.82,834,787,47,64,254,19.7333
12804.47,833,783,50,64,253,19.8667
12818.16,830,783,47,63,254,19.7333
12830.89,829,780,49,64,252,19.9
12843.86,830,783,47,64,254,19.9667
12857.19,827,780,47,67,252,19.9667
12869.94,831,783,48,64,254,19.9667
12883.12,831,779,52,65,254,20.2333
12896.22,831,783,48,65,253,20.0333
12909.11,824,780,44,66,253,19.9333
12921.66,824,780,44,64,253,20.0667
12933.6,828,784,44,67,254,20.0667
12945.57,828,784,44,64,254,19.9333
12957.36,821,777,44,63,252,20.1
12969.74,828,784,44,66,254,20.2667
12981.64,827,782,45,63,252,20.3
12993.41,828,784,44,67,255,20.4
13005.38,828,784,44,65,254,20.3667
13017.05,821,779,42,64,253,20.4667
13029.27,826,784,42,65,254,20.4667
13041.16,829,783,46,67,255,20.5667
13052.91,824,781,43,66,253,20.4667
13065.7,829,785,44,65,254,20.6
13077.51,824,778,46,63,252,20.6333
13089.46,828,784,44,65,254,20.3667
13101.39,829,784,45,66,254,20.4667
13113.15,823,779,44,66,252,20.7333
13125.46,828,783,45,67,253,20.6333
13137.38,824,780,44,66,253,20.3667
13149.24,828,784,44,65,255,20.6333
13161.17,827,784,43,66,255,20.6
13172.96,825,781,44,66,253,20.7667
13185.63,827,785,42,66,255,20.8
13197.55,829,783,46,65,253,20.7
13209.31,826,785,41,65,254,20.7
13221.22,828,783,45,67,254,20.6333
13232.86,822,780,42,66,252,20.7
13245.14,827,785,42,65,254,20.6333
13257.04,828,785,43,65,254,20.7
13271.3,831,784,47,68,255,20.4667
13283.25,828,783,45,67,255,21.0333
13295.1,823,781,42,67,253,20.6667
13308.79,825,782,43,65,255,20.7
13320.69,830,785,45,68,255,20.5333
13335.36,828,784,44,66,254,20.7333
13347.32,828,784,44,68,254,20.9333
13359.37,828,783,45,66,254,20.6667
13371.44,827,784,43,67,254,20.8
13383.3,825,780,45,64,252,20.4333
13395.23,827,784,43,67,254,20.7667
13407.15,828,783,45,67,254,20.9
13418.8,828,784,44,67,254,21.1333
13430.98,827,784,43,70,254,21.5
13442.88,829,784,45,69,254,22.0333
13454.63,828,784,44,73,254,22.3667
13466.84,827,784,43,73,253,22.3
13478.71,824,780,44,71,252,22.6333
13490.66,825,779,46,72,254,22.8
13502.62,828,783,45,73,254,23.0667
13514.34,827,783,44,72,253,22.7333
13526.41,829,784,45,71,254,23.4
13538.3,824,780,44,71,253,23.2333
13550.15,825,784,41,72,254,23.0
13562.07,828,784,44,74,255,23.2667
13573.81,828,783,45,73,254,23.0667
13586.04,828,784,44,71,254,22.8
13597.96,828,783,45,74,254,23.0333
13609.71,828,784,44,72,254,22.8667
13621.71,836,785,51,73,255,23.2
13634.19,832,784,48,72,254,23.0
13647.15,835,787,48,73,255,22.7667
13659.9,833,782,51,72,254,22.8667
13672.58,835,786,49,71,255,23.3667
13685.58,842,787,55,73,255,23.1
13698.34,836,786,50,73,255,23.0333
13711.38,835,785,50,74,255,22.9
13724.11,831,783,48,74,254,23.2667
13736.81,834,786,48,73,255,22.8667
13749.68,835,786,49,73,255,23.5333
13762.18,835,785,50,75,255,23.3333
13775.0,832,786,46,73,253,23.3667
13787.55,831,782,49,76,253,23.4667
13800.1,835,786,49,75,255,23.7
13812.99,831,791,40,73,255,23.5667
13825.4,834,785,49,75,255,23.5333
13838.1,834,784,50,75,256,23.3333
13850.6,831,783,48,74,253,23.7667
13863.16,834,785,49,78,255,23.8333
13875.78,835,786,49,76,255,23.8667
13888.13,834,785,49,76,255,23.9
13900.89,831,793,38,77,255,24.2
13913.42,831,782,49,75,253,24.0
13926.02,832,786,46,77,254,24.2667
13938.39,839,787,52,77,255,24.1667
13950.51,832,785,47,76,254,24.2333
13963.05,831,784,47,77,255,24.4333
13975.47,831,782,49,76,254,24.1667
13987.85,833,785,48,78,255,24.0667
14000.16,833,785,48,75,255,24.2
14012.32,832,785,47,77,255,24.1
14024.95,831,783,48,77,254,24.3667
14037.69,834,785,49,76,254,24.3
14050.31,833,783,50,78,255,24.3
14062.88,834,785,49,78,255,24.5333
14075.25,834,785,49,77,255,24.6333
14087.99,833,785,48,77,255,24.5333
14100.49,832,784,48,78,254,24.3
14113.15,835,785,50,77,255,24.7
14125.76,832,786,46,79,255,24.6667
14138.02,833,785,48,78,253,24.9
14150.46,834,784,50,79,254,24.5667
14162.81,830,783,47,78,254,25.0
14175.43,834,784,50,76,254,24.7333
14188.2,832,786,46,80,255,24.7333
14200.85,830,783,47,78,253,25.1
14214.15,832,786,46,81,255,25.2
14226.5,836,782,54,79,253,25.1667
14239.84,831,783,48,78,254,24.6
14252.45,834,785,49,78,255,25.1667
14265.08,829,782,47,81,254,24.9667
14278.57,834,786,48,78,255,25.1
14291.15,832,783,49,81,254,25.1
14304.55,834,786,48,80,254,25.1667
14317.13,835,786,49,78,254,24.9333
14329.83,835,786,49,79,255,24.9333
14343.09,835,785,50,81,255,25.1333
14355.57,832,783,49,80,253,25.1667
14368.57,835,786,49,79,255,25.1
14381.19,834,786,48,79,255,25.1333
14393.87,835,785,50,79,255,25.2
14406.48,833,783,50,80,255,25.0
14418.85,831,783,48,79,253,25.1
14431.98,835,785,50,78,255,25.1
14444.56,832,785,47,80,255,25.1333
14457.3,833,784,49,80,255,25.2
14469.89,833,786,47,81,255,25.4
14482.3,830,782,48,78,254,25.2
14495.59,834,783,51,81,255,25.0333
14508.18,832,786,46,80,255,25.0
14520.96,835,785,50,79,254,25.0667
14533.55,834,786,48,83,255,25.0667
14546.08,830,782,48,77,253,25.0667
14559.28,831,786,45,79,254,25.5667
14571.87,833,785,48,80,254,25.0667
14584.63,834,786,48,80,255,25.7
14597.27,833,786,47,81,255,25.2
14609.71,831,782,49,80,253,25.4
14622.95,834,787,47,80,255,25.0
14635.58,835,786,49,80,255,25.4
14648.29,834,785,49,81,255,25.0
14660.87,834,786,48,80,254,25.3
14673.38,831,781,50,78,253,25.5333
14686.97,836,787,49,80,255,25.4
14699.49,832,783,49,80,254,25.5
14712.89,829,783,46,79,254,25.3667
14725.79,834,786,48,79,255,25.3333
14738.5,831,783,48,80,254,25.3333
14752.0,835,785,50,79,254,25.5333
14764.58,831,784,47,79,255,25.7
14777.81,835,786,49,79,255,25.4333
14790.41,832,781,51,79,254,25.6667
14803.26,834,787,47,80,255,25.4667
14816.01,834,787,47,79,254,25.6667
14828.42,831,782,49,81,254,25.4333
14841.49,835,785,50,79,255,25.2333
14854.13,831,782,49,80,254,25.4333
14867.21,832,786,46,81,254,25.1
14879.79,834,785,49,79,255,24.8667
14892.36,831,782,49,81,254,24.9667
14906.04,833,784,49,80,254,25.5
14918.57,833,783,50,78,254,25.2333
14931.82,835,786,49,82,254,25.4333
14944.43,834,784,50,79,254,25.1333
14957.17,835,786,49,81,254,25.4
14970.07,833,787,46,81,255,25.3667
14982.47,832,781,51,80,253,25.0333
14995.47,834,784,50,80,255,25.3
15008.06,834,786,48,79,254,25.1333
15020.71,835,785,50,81,255,25.1667
15033.27,835,783,52,80,255,25.0667
15045.7,830,783,47,80,254,25.5667
15058.75,835,785,50,80,255,25.2667
15071.34,834,785,49,79,254,25.2
15084.16,834,784,50,80,255,25.0667
15096.81,835,785,50,78,254,25.4333
15109.34,831,782,49,78,254,25.4
15122.9,835,785,50,80,255,25.3667
15135.38,832,783,49,82,254,25.4333
15148.63,835,785,50,79,255,25.1667
15161.22,835,781,54,80,255,25.2667
15173.94,833,785,48,81,255,25.2667
15186.9,834,788,46,80,255,25.3333
15199.28,832,783,49,80,254,25.3
15212.22,835,785,50,81,255,24.9667
15224.8,830,783,47,80,254,25.1667
15245.6,835,786,49,78,255,25.3
15258.07,832,783,49,80,253,25.6667
15271.39,833,785,48,81,254,25.3333
15283.91,834,784,50,79,254,25.3667
15296.46,832,783,49,78,254,25.6333
15309.88,834,785,49,79,255,25.2
15322.4,831,783,48,81,254,25.6667
15335.53,835,786,49,79,256,25.1667
15348.09,834,785,49,79,254,25.4
15360.7,834,787,47,79,254,25.5333
15373.28,835,784,51,80,255,25.4667
15385.57,831,783,48,80,254,25.4333
15398.49,835,784,51,81,255,25.5333
15411.16,832,782,50,79,254,25.4667
15424.06,836,786,50,79,255,25.3
15436.76,835,786,49,79,255,25.1
15449.23,829,782,47,78,254,25.2667
15462.47,834,786,48,78,254,25.0
15475.08,835,786,49,79,255,24.9
15487.83,834,785,49,79,255,25.0333
15500.38,835,784,51,80,255,25.0
15512.84,830,780,50,77,254,24.8
15526.25,835,786,49,79,255,24.6
15538.81,834,783,51,79,256,24.4667
15551.57,834,784,50,78,255,24.3667
15564.14,834,786,48,75,255,24.8
15576.61,826,782,44,77,253,24.7
15589.82,834,784,50,78,255,24.6
15602.42,834,785,49,77,255,24.3333
15615.2,835,787,48,78,255,24.3
15627.77,834,784,50,77,254,24.5667
15640.23,831,782,49,76,253,24.1667
15653.54,834,786,48,77,255,24.2
15666.09,835,783,52,75,255,24.0
15678.85,833,785,48,78,255,24.1
15691.43,834,785,49,77,255,24.1333
15703.9,830,781,49,74,253,23.9333
15717.29,834,785,49,76,255,23.7
15729.84,835,786,49,73,254,22.8333
15742.68,834,786,48,70,254,22.4667
15755.31,834,785,49,71,255,21.9333
15772.62,831,785,46,67,254,21.7
15785.77,834,787,47,68,255,21.0
15798.18,832,781,51,66,253,20.8333
15811.69,832,783,49,67,254,20.7333
15824.48,830,781,49,65,253,20.8333
15838.0,832,783,49,68,254,20.7
15850.56,830,781,49,67,253,20.7
15863.3,824,779,45,66,253,20.8
15875.28,824,779,45,67,253,20.8333
15888.09,824,779,45,68,252,20.7333
15900.75,826,784,42,65,255,20.7
15912.67,828,782,46,64,254,20.5667
15924.43,829,784,45,66,254,20.2
15936.42,822,778,44,65,255,20.1667
15948.11,824,780,44,64,253,20.0667
15960.38,827,784,43,64,254,20.0667
15972.29,828,784,44,64,255,20.0667
15984.0,824,780,44,67,253,20.0333
15996.88,828,784,44,64,254,20.1
16008.71,830,779,51,65,253,20.1
16020.67,828,784,44,65,255,19.9
16032.57,828,784,44,64,255,20.0
16044.36,824,781,43,63,254,19.9333
16056.54,827,785,42,64,254,19.7
16068.46,823,780,43,63,253,19.7667
16080.38,825,783,42,63,253,19.5667
16092.33,824,780,44,63,253,19.4333
16104.5,824,781,43,63,253,19.6
16117.02,826,782,44,63,252,19.4333
16128.95,828,783,45,62,253,19.5333
16140.73,827,784,43,63,253,19.7
16152.67,828,784,44,63,254,19.8
16164.36,825,780,45,62,253,19.8333
16176.64,826,783,43,63,254,19.3667
16188.53,828,783,45,63,254,19.5
16200.23,823,780,43,64,253,19.6
16213.05,829,784,45,62,254,19.4333
16224.89,822,777,45,62,251,19.3333
16236.82,827,785,42,63,254,19.1667
16248.68,828,784,44,65,255,19.0333
16260.4,824,777,47,62,250,19.2333
16272.65,826,784,42,62,254,19.1333
16284.55,823,780,43,62,253,19.0
16296.47,828,785,43,61,255,18.8667
16308.39,828,784,44,61,255,19.0667
16320.18,824,779,45,63,253,19.0
16332.69,821,784,37,60,254,19.1333
16344.61,829,781,48,61,253,19.5667
16356.42,828,785,43,61,255,18.9
16368.36,829,785,44,63,253,19.0333
16380.1,825,779,46,60,253,19.3
16392.79,827,784,43,62,254,18.9333
16404.7,827,785,42,63,252,19.2
16416.45,824,781,43,63,254,19.0333
16428.97,828,784,44,63,254,18.9667
16440.75,824,777,47,63,251,19.1
16452.72,827,784,43,62,254,19.0667
16464.64,829,783,46,62,254,19.2333
16476.42,824,779,45,62,251,19.0333
16488.66,827,784,43,62,255,19.0333
16500.57,823,780,43,62,252,18.7667
16512.48,827,780,47,62,255,19.3333
16524.41,827,781,46,61,253,19.0333
16536.18,824,781,43,63,253,18.8333
16548.72,829,784,45,62,254,18.9667
16560.71,826,783,43,62,254,19.0667
16572.93,832,783,49,61,254,19.2333
16587.1,835,787,48,62,255,19.0
16599.56,830,782,48,61,254,18.9333
16612.9,834,785,49,62,255,18.9
16625.48,831,783,48,61,254,19.1333
16638.14,831,784,47,62,255,18.8
16650.72,833,786,47,63,255,18.9
16663.28,830,783,47,63,254,18.7667
16676.24,835,785,50,62,255,18.9667
16689.24,832,783,49,62,254,18.9333
16702.98,834,786,48,62,254,19.0333
16715.57,831,782,49,63,253,19.1333
16733.42,833,786,47,64,255,19.0
16746.04,836,780,56,60,254,18.9667
16764.57,831,777,54,62,255,18.9
16777.14,831,782,49,62,253,19.1
16790.03,831,783,48,61,254,19.0
16803.19,836,785,51,64,255,18.8
16815.82,835,785,50,61,255,18.9333
16828.53,835,786,49,60,255,18.9333
16841.13,833,784,49,62,255,18.6667
16853.63,832,779,53,62,253,18.3
16866.8,837,786,51,60,255,18.5
16879.38,833,786,47,62,255,18.3667
16892.14,834,785,49,61,254,18.4333
16904.75,834,786,48,61,255,18.4667
16917.14,829,783,46,62,254,18.6333
16930.3,833,786,47,61,255,18.3
16942.9,830,785,45,62,254,18.1667
16955.82,835,785,50,59,255,18.3667
16968.41,834,784,50,62,255,18.3
16980.98,831,782,49,62,253,18.2333
16994.47,834,784,50,62,254,18.3667
17007.06,832,783,49,62,254,18.5
17020.45,835,785,50,61,254,18.4667
17033.01,836,785,51,60,254,18.3667
17045.8,832,785,47,59,255,18.3667
17058.7,834,785,49,62,255,18.4667
17071.21,831,783,48,61,254,18.2333
17084.1,835,786,49,60,255,18.3333
17096.78,833,785,48,60,255,18.4667
17109.41,833,785,48,61,254,18.5333
17122.0,835,786,49,61,255,18.4333
17134.35,831,783,48,61,254,18.5333
17147.27,835,785,50,62,255,18.4333
17159.88,829,791,38,62,255,18.4667
17172.67,833,786,47,61,254,18.4667
17185.34,835,786,49,61,255,18.3333
17197.91,830,782,48,60,253,18.4333
17211.36,833,786,47,61,254,18.5667
17223.92,830,781,49,62,254,18.7
17237.51,834,786,48,61,254,18.9333
17250.1,831,791,40,64,255,19.0333
17262.83,832,784,48,62,254,19.0
17275.92,834,786,48,62,254,19.2
17288.39,831,782,49,62,254,19.2667
17301.3,834,786,48,63,255,19.2333
17313.92,834,785,49,63,255,19.2333
17326.57,834,786,48,63,255,19.3
17339.15,834,784,50,64,255,19.7
17351.49,831,782,49,63,254,20.0333
17364.69,834,785,49,64,255,20.4333
17377.38,834,785,49,65,255,19.8667
17390.13,832,784,48,64,254,19.7333
17402.76,834,785,49,65,254,20.0
17415.18,831,783,48,65,254,20.1
17428.39,834,785,49,65,255,20.0667
17440.98,833,786,47,66,255,20.0
17453.75,836,785,51,65,255,20.2
17466.34,832,785,47,65,255,20.2
17479.28,831,783,48,66,254,20.4
17492.5,834,786,48,66,255,20.1667
17505.1,834,786,48,66,255,20.3333
17517.81,833,786,47,65,254,20.2
17530.39,834,785,49,67,255,20.1333
17542.85,831,783,48,64,253,20.1
17556.08,831,792,39,64,255,20.0333
17568.71,834,785,49,65,255,20.2667
17581.47,834,785,49,64,255,20.4333
17594.06,833,786,47,67,253,20.3
17606.53,831,783,48,65,252,20.5667
17619.82,835,786,49,66,255,20.2333
17632.4,831,783,48,66,253,20.4
17645.26,832,786,46,67,256,20.4333
17657.82,833,786,47,66,254,20.4333
17670.35,831,781,50,66,253,20.4
17683.73,833,786,47,64,255,20.3667
17696.32,831,782,49,66,254,20.4
17709.7,834,786,48,65,255,20.6333
17722.28,834,785,49,66,254,20.4
17734.94,830,781,49,66,253,20.5
17748.24,835,785,50,65,255,20.3667
17760.78,832,783,49,66,254,20.3667
17774.11,831,783,48,66,255,20.4
17786.82,834,786,48,66,254,20.4
17799.52,835,786,49,66,254,20.2
17812.46,834,785,49,66,255,20.4
17824.92,831,784,47,66,254,20.4
17837.95,835,784,51,66,254,20.2333
17850.51,831,782,49,67,253,20.3667
17863.43,835,786,49,66,255,20.4
17876.06,835,786,49,66,255,20.5667
17888.63,829,782,47,65,253,20.1667
17902.16,834,784,50,65,255,20.3333
17914.81,839,781,58,65,253,20.2
17928.15,835,786,49,64,255,20.2
17940.72,834,786,48,66,255,20.2667
17953.46,835,786,49,66,255,20.3
17966.28,833,786,47,66,255,20.5
17978.77,831,782,49,64,254,20.2333
17991.72,835,785,50,65,254,20.3
18004.34,833,785,48,64,254,20.5
18016.95,835,784,51,66,255,20.3333
18029.55,833,786,47,66,254,20.3
18041.98,831,782,49,64,253,20.2667
18055.15,833,787,46,66,254,20.2
18067.65,830,782,48,67,254,20.0667
18080.48,834,786,48,64,255,20.5333
18092.99,830,784,46,67,254,20.1333
18105.48,831,782,49,64,254,20.2
18119.0,834,786,48,64,256,20.4
18131.46,826,790,36,66,251,20.2667
18145.41,831,783,48,65,254,20.4667
18159.41,831,783,48,67,254,20.4
18172.05,834,786,48,67,255,20.6667
18184.62,834,786,48,66,255,20.3333
18197.06,831,783,48,66,254,20.3
18210.01,834,784,50,65,255,20.2
18222.55,836,783,53,65,253,20.5667
18235.38,831,785,46,67,254,20.3333
18247.99,834,786,48,65,255,20.4667
18260.37,831,783,48,66,254,20.2667
18273.25,833,786,47,66,254,20.4667
18286.24,832,783,49,66,253,20.3667
18299.55,834,787,47,67,255,20.2333
18312.11,830,784,46,64,255,20.3
18325.59,833,787,46,66,255,20.0667
18338.43,834,786,48,65,255,20.4
18350.85,831,783,48,65,254,20.2667
18364.04,834,787,47,67,255,20.5667
18376.7,831,783,48,67,254,20.4
18389.29,834,784,50,66,255,20.5667
18402.24,840,787,53,64,256,20.5
18414.63,831,783,48,65,253,20.5333
18427.89,832,785,47,65,255,20.5667
18440.45,830,782,48,66,254,20.3
18454.36,833,786,47,66,255,20.1333
18466.95,831,783,48,63,254,20.3667
18479.81,832,786,46,66,255,20.1
18492.59,832,786,46,67,256,20.2333
18505.03,832,783,49,63,254,20.4333
18518.55,834,785,49,65,255,20.3
18531.14,831,783,48,67,254,20.5
18543.8,834,785,49,65,254,20.5667
18556.35,835,786,49,65,254,20.5333
18568.93,831,783,48,66,253,20.6
18582.24,833,786,47,67,254,20.2667
18594.8,831,782,49,66,253,20.0
18607.79,835,786,49,64,255,20.2333
18620.64,831,783,48,66,254,20.2667
18633.22,832,786,46,65,254,20.7333
18646.49,835,785,50,66,255,20.5
18658.96,831,783,48,67,254,20.2333
18672.37,836,786,50,66,255,20.6
18685.01,831,783,48,65,254,20.2667
18697.63,835,786,49,66,254,20.3333
18710.26,833,786,47,65,254,20.4667
18722.72,831,782,49,66,253,20.4667
18736.01,834,785,49,65,255,20.8
18748.83,831,783,48,66,253,20.5333
18761.65,826,790,36,65,254,20.5667
18774.49,828,781,47,66,253,20.6
18787.37,832,783,49,66,254,20.4333
18800.73,831,783,48,66,254,20.3333
18813.48,830,783,47,66,254,20.5333
18826.12,829,781,48,65,254,20.5667
18842.06,831,783,48,66,254,20.5
18854.8,832,782,50,65,254,20.2667
18868.08,826,780,46,65,253,20.4
18881.81,832,786,46,66,255,20.4667
18895.16,827,784,43,66,254,20.2667
18907.02,824,781,43,64,252,20.3333
18920.1,828,784,44,66,255,20.4667
18932.03,824,780,44,65,253,20.4667
18943.96,828,784,44,64,254,20.4
18955.88,828,784,44,64,254,20.4
18967.64,824,780,44,66,253,20.5333
18980.05,827,785,42,66,254,20.3333
18992.02,824,779,45,65,253,20.4333
19005.82,828,784,44,67,254,20.3
19017.74,829,783,46,67,254,20.6
19029.5,826,783,43,65,254,20.7
19041.61,828,783,45,65,254,20.1667
19053.53,827,783,44,64,253,20.5
19065.29,827,785,42,66,253,20.2
19077.24,828,784,44,67,254,20.6
19088.96,822,779,43,65,253,20.1667
19100.95,827,783,44,66,254,20.4333
19113.02,827,784,43,67,254,20.3333
19124.98,822,780,42,63,253,20.2667
19136.87,827,785,42,66,254,20.1667
19148.76,827,783,44,66,254,20.4667
19160.45,828,783,45,67,254,20.4
19172.56,828,784,44,65,254,20.4
19184.47,829,783,46,68,254,20.2
19196.22,827,784,43,66,254,20.3
19208.48,828,784,44,64,255,20.8
19220.37,824,780,44,66,253,20.3
19232.28,827,784,43,65,254,20.3
19244.2,827,785,42,65,255,20.1667
19256.05,825,782,43,65,254,20.3667
19268.11,827,785,42,64,255,20.3
19280.02,825,780,45,64,252,20.4333
19291.91,828,784,44,66,255,20.4
19303.82,827,783,44,64,254,20.2333
19315.48,828,783,45,66,254,20.5333
19327.68,828,784,44,66,254,20.2667
19339.57,830,783,47,64,254,20.4667
19351.27,827,783,44,65,253,20.4667
19363.54,822,785,37,66,254,20.3333
19375.47,823,779,44,65,252,20.7
19387.38,828,784,44,65,255,20.1333
19399.26,829,783,46,65,254,20.5333
19411.04,826,778,48,66,256,20.3333
19423.12,827,785,42,67,254,20.4333
19435.08,826,780,46,67,253,20.6
19453.8,827,785,42,65,254,20.3667
19465.73,828,783,45,67,254,20.2667
19477.86,826,784,42,67,254,20.1667
19489.82,829,783,46,64,254,20.3333
19501.6,823,781,42,65,253,20.0
19514.3,828,784,44,64,255,19.9333
19526.36,827,784,43,64,254,20.1
19538.21,827,785,42,64,254,20.0
19550.18,827,783,44,64,255,19.7667
19561.96,827,783,44,65,253,19.8
19573.98,827,784,43,64,254,19.8333
19586.14,828,784,44,65,254,19.4333
19597.97,831,783,48,63,254,19.7
19611.2,833,785,48,63,254,19.6
19623.79,835,785,50,62,255,19.5
19636.59,835,785,50,64,255,19.3667
19649.23,833,786,47,62,254,18.9667
19661.65,836,784,52,62,252,18.9667
19674.8,832,787,45,61,254,18.8333
19687.49,834,785,49,60,254,18.7
19700.28,834,786,48,63,255,18.6667
19712.87,834,785,49,61,255,18.6667
19725.76,832,782,50,61,253,18.7
19739.11,835,786,49,60,255,18.4
19751.67,827,788,39,60,253,18.4
19765.08,833,785,48,59,254,18.3
19777.66,830,783,47,59,254,18.2
19790.34,834,785,49,60,254,18.2
19803.83,834,787,47,61,254,18.2333
19816.25,832,782,50,59,253,18.0667
19829.42,834,786,48,60,255,18.0333
19841.97,831,781,50,59,254,17.8667
19854.6,834,787,47,60,255,18.0
19867.12,833,786,47,58,255,17.6667
19879.56,831,783,48,61,254,17.7333
19892.53,834,786,48,59,255,17.8667
19905.11,830,783,47,59,254,17.7
19917.78,835,785,50,59,254,17.8667
19930.36,832,786,46,60,255,17.6
19942.8,830,783,47,60,254,17.9
19956.03,834,786,48,59,255,17.7667
19968.62,831,782,49,61,253,17.8
19981.64,833,787,46,60,254,17.8667
19994.25,830,783,47,60,253,17.6667
20006.93,833,786,47,60,255,17.6667
20020.5,836,787,49,59,255,17.7667
20032.89,830,783,47,58,254,17.7
20046.4,835,786,49,60,255,17.7667
20059.13,831,783,48,59,253,17.7333
20071.72,835,786,49,60,255,18.0
20084.27,834,786,48,59,255,17.8667
20096.73,830,783,47,60,253,17.8
20109.69,834,786,48,59,254,17.7333
20122.26,831,783,48,59,254,17.6
20135.04,834,786,48,59,255,17.9
20147.62,833,787,46,60,256,17.8333
20160.01,830,783,47,58,254,17.6333
20173.11,834,787,47,59,255,17.6667
20186.06,830,783,47,60,253,17.7333
20199.07,837,786,51,59,255,17.7
20212.47,826,778,48,57,252,17.6333
20227.38,833,785,48,60,254,17.8
20239.85,834,785,49,60,255,17.7
20252.13,831,783,48,60,254,17.8
20265.06,835,785,50,59,254,17.5667
20277.54,830,783,47,59,254,17.5
20290.16,833,786,47,61,255,17.6333
20302.72,832,786,46,62,254,17.8
20315.04,831,783,48,60,254,17.6333
20327.8,831,787,44,57,254,17.9667
20340.29,831,781,50,60,253,17.8333
20353.22,835,786,49,60,255,17.7667
20365.78,831,783,48,59,254,17.9667
20378.4,832,783,49,59,255,17.8
20391.56,833,786,47,60,254,17.6667
20403.95,831,783,48,59,253,17.6667
20417.16,836,784,52,58,255,17.7
20429.65,831,783,48,60,254,17.6667
20442.16,835,786,49,59,254,17.6333
20454.71,835,785,50,59,254,17.7333
20467.06,830,782,48,60,253,17.7
20480.2,834,786,48,59,255,17.7333
20492.67,831,783,48,59,253,17.9
20505.21,835,784,51,58,255,17.7
20517.67,834,786,48,58,254,17.9
20529.98,831,783,48,58,254,17.6333
20542.82,833,786,47,60,254,17.7333
20555.3,831,783,48,59,254,17.6333
20567.81,835,784,51,59,255,17.7333
20580.31,834,788,46,58,255,17.6333
20592.59,829,782,47,60,253,17.7667
20605.61,835,784,51,61,255,17.7667
20618.1,830,783,47,59,254,17.7
20630.6,834,784,50,60,255,17.7
20643.09,834,787,47,60,254,18.0
20655.51,831,783,48,60,254,18.0333
20668.4,835,785,50,62,255,18.2
20680.89,831,783,48,60,254,18.3333
20693.4,833,786,47,62,255,18.4667
20705.98,835,782,53,60,254,18.5
20718.27,831,783,48,62,254,18.5333
20731.12,834,785,49,62,255,18.5667
20743.6,832,783,49,61,254,18.7
20756.15,833,785,48,63,254,18.9
20768.63,833,786,47,61,254,18.9
20780.94,831,783,48,63,254,18.9667
20793.81,833,786,47,63,255,19.1
20806.35,831,782,49,62,254,19.0667
20818.87,833,786,47,63,254,19.2
20832.42,840,786,54,64,255,19.3
20844.84,831,783,48,63,254,19.5667
20857.54,834,785,49,63,254,19.5333
20870.06,831,783,48,65,254,19.5667
20882.61,833,786,47,66,255,19.9
20895.19,831,783,48,64,253,19.8
20907.97,831,784,47,64,254,19.8333
20920.96,832,783,49,65,255,20.1
20933.41,830,782,48,66,253,19.9
20946.39,833,786,47,65,255,19.8667
20958.87,831,783,48,65,253,20.0
20971.23,830,783,47,65,253,20.0667
20984.67,834,786,48,64,254,20.2
20997.08,832,783,49,65,254,19.9333
21010.3,834,786,48,65,255,20.1333
21022.78,831,783,48,64,254,20.2667
21035.37,834,786,48,66,255,20.1667
21048.1,828,788,40,67,256,20.5333
21060.44,831,783,48,66,254,20.4333
21073.54,833,784,49,66,254,20.0333
21086.05,831,782,49,66,254,20.2
21098.53,834,786,48,65,255,20.4
21111.05,834,787,47,67,255,20.3667
21123.38,831,782,49,65,254,20.4667
21136.21,835,784,51,66,255,21.0
21148.67,831,782,49,68,254,20.7667
21161.2,832,786,46,67,254,20.7667
21173.69,835,785,50,68,255,20.7667
21185.95,832,782,50,67,254,21.0333
21198.83,833,785,48,66,255,20.9
21211.35,831,782,49,66,254,20.6667
21223.87,834,787,47,67,254,20.9
21236.37,834,786,48,68,255,21.0333
21248.66,833,783,50,68,254,20.7
21261.54,835,784,51,67,255,21.0667
21274.02,829,783,46,67,254,21.2667
21286.62,834,786,48,67,255,21.0667
21299.07,828,788,40,67,256,20.9333
21311.46,831,783,48,69,254,21.1
21324.33,833,784,49,68,255,21.4
21336.84,831,784,47,68,254,21.5333
21349.3,836,785,51,69,254,22.0
21361.8,834,787,47,69,255,22.0333
21374.12,831,783,48,70,254,22.3667
21387.07,835,785,50,71,255,22.4667
21399.52,830,782,48,71,254,22.4
21412.08,834,785,49,72,255,22.6667
21424.57,834,786,48,72,254,22.5333
21436.91,831,782,49,71,253,22.6667
21449.71,832,785,47,72,255,22.3667
21462.18,831,783,48,74,255,22.5667
21474.7,832,786,46,73,255,22.7
21487.28,835,786,49,74,254,22.5667
21499.55,830,782,48,72,254,23.1
21512.46,835,786,49,73,255,22.8667
21525.01,832,783,49,73,253,22.9333
21537.62,834,785,49,73,255,23.2333
21550.07,835,785,50,73,254,23.4667
21562.34,831,783,48,73,254,23.3333
21575.34,831,783,48,73,253,23.3667
21588.01,832,783,49,73,254,23.4333
21600.84,835,786,49,74,255,23.4
21613.37,830,784,46,74,254,23.6667
21625.84,832,782,50,76,254,23.5
21639.19,835,785,50,74,255,23.0
21651.78,832,783,49,75,254,23.3667
21665.13,834,786,48,74,255,23.6333
21677.63,829,783,46,73,253,23.4667
21690.23,831,784,47,78,254,23.5333
21704.21,835,784,51,76,255,23.7
21716.86,831,783,48,74,254,23.6
21729.97,834,785,49,75,255,23.8
21742.65,829,781,48,74,254,23.6333
21756.47,831,783,48,76,254,23.8
21769.01,824,780,44,75,253,23.9
21781.53,831,784,47,74,254,23.8333
21793.98,831,783,48,75,254,23.5
21806.37,829,779,50,76,254,23.7333
21819.48,824,780,44,74,253,23.6667
21831.8,824,780,44,75,253,23.8333
21843.78,827,783,44,73,254,23.7667
21855.69,829,785,44,75,254,23.8333
21867.31,824,777,47,76,253,23.8
21879.41,827,784,43,74,254,23.4333
21891.27,827,780,47,74,254,23.6
21902.96,824,780,44,76,253,23.6333
21915.72,827,785,42,73,255,23.9667
21927.5,824,779,45,75,252,23.4667
21939.43,827,784,43,74,255,24.1
21951.32,828,784,44,75,254,23.7333
21963.05,823,780,43,73,253,23.7667
21975.32,827,784,43,74,254,23.7333
21987.2,823,780,43,74,253,23.7
21999.01,827,785,42,75,255,23.5667
22010.91,829,784,45,73,255,23.8667
22022.59,824,781,43,74,253,23.5667
22035.23,827,785,42,74,254,23.6667
22047.11,829,783,46,73,254,23.6667
22058.85,825,780,45,74,254,23.8333
22071.34,829,784,45,76,254,24.0333
22083.03,823,780,43,74,253,23.8667
22094.97,827,784,43,74,255,23.7333
22106.83,828,784,44,74,254,23.7333
22118.49,824,780,44,74,252,24.0
22130.64,828,784,44,73,254,23.9667
22142.51,822,780,42,74,253,23.7333
22154.39,828,784,44,74,254,24.2667
22166.26,827,784,43,74,254,23.5333
22178.0,824,777,47,75,253,23.5333
22190.58,824,780,44,73,254,23.3333
22202.49,827,782,45,72,253,23.4
22214.27,827,785,42,72,254,23.1
22226.26,828,784,44,71,255,22.6
22237.92,821,778,43,71,253,22.4
22250.02,826,785,41,70,254,22.6333
22261.98,824,781,43,72,253,22.0333
22274.12,821,778,43,70,251,22.4667
22286.99,828,784,44,68,254,22.4
22298.77,823,779,44,69,253,21.7333
22310.69,827,785,42,68,255,21.5
22322.56,828,784,44,66,254,21.4
22334.23,823,778,45,65,253,21.2333
22346.47,828,782,46,66,254,20.8
22358.33,824,779,45,65,253,21.1333
22370.19,826,785,41,67,255,20.8667
22382.06,827,784,43,65,254,20.4333
22393.73,823,780,43,64,253,20.1667
22406.29,827,784,43,65,254,19.9
22418.17,828,783,45,64,254,19.7333
22429.93,825,783,42,63,253,19.7667
22442.35,830,784,46,63,254,19.5
22454.13,824,780,44,62,253,19.6667
22465.99,828,784,44,61,254,19.6
22477.87,828,785,43,61,255,19.4
22489.61,824,780,44,61,253,19.1
22501.95,827,784,43,60,254,18.8333
22513.84,828,783,45,59,253,18.6333
22525.59,836,786,50,59,255,18.3333
22538.12,835,787,48,61,254,18.2667
22550.52,832,782,50,59,254,18.1
22563.51,835,787,48,61,255,18.2
22576.23,832,783,49,59,254,17.9
22588.95,832,782,50,59,253,17.4333
22602.65,836,787,49,58,254,17.5
22615.35,833,784,49,58,253,17.2
22628.81,834,786,48,56,255,16.8667
22641.29,832,783,49,58,254,16.5
22653.86,834,785,49,57,254,16.5667
22666.36,833,787,46,57,254,16.5333
22678.66,831,783,48,56,254,16.4667
22691.52,834,784,50,54,255,16.1333
22704.06,831,784,47,55,254,16.0
22716.64,833,787,46,55,255,15.9667
22729.13,832,786,46,54,255,15.2667
22741.45,830,782,48,54,254,15.2
22754.38,835,786,49,55,255,15.6
22766.85,833,783,50,53,254,14.9667
22779.37,834,784,50,55,255,14.8333
22791.86,832,786,46,53,255,14.7333
22804.18,831,782,49,53,254,14.5667
22817.02,834,786,48,52,255,14.4
22829.51,831,783,48,53,256,14.3
22842.04,834,786,48,51,255,14.2667
22854.52,835,784,51,53,255,14.0
22866.79,831,783,48,53,254,13.9333
22879.73,835,785,50,51,255,13.7333
22892.22,830,782,48,50,253,13.3667
22904.79,834,784,50,50,255,13.3333
22917.24,832,786,46,52,254,13.2
22929.54,831,783,48,51,254,13.1667
22942.37,831,783,48,52,254,13.0333
22955.1,832,783,49,51,255,12.8667
22967.69,834,785,49,50,254,12.8333
22980.2,834,785,49,50,255,12.7667
22992.68,831,782,49,49,253,12.7
23005.63,834,785,49,50,254,12.4
23018.12,829,782,47,50,254,12.3333
23030.98,834,786,48,49,256,12.2
23043.48,831,783,48,49,254,12.0
23055.89,830,780,50,49,253,11.8333
23068.96,835,786,49,49,255,11.6667
23081.47,832,784,48,49,254,11.4
23094.79,834,786,48,48,255,11.4333
23107.26,831,782,49,48,253,11.1333
23119.87,835,786,49,47,255,10.7
23132.72,833,785,48,48,254,10.6
23145.08,832,783,49,48,253,10.5333
23158.19,836,784,52,46,254,10.4
23170.72,832,783,49,47,252,10.3333
23183.21,835,785,50,47,254,10.2667
23195.79,834,786,48,47,255,10.3
23208.12,831,783,48,47,253,10.2333
23221.2,834,785,49,47,255,10.1
23233.7,831,783,48,46,254,9.9
23246.34,835,785,50,47,255,9.9667
23258.83,833,786,47,46,254,10.0667
23271.11,831,783,48,46,254,9.9
23284.05,834,786,48,46,255,9.9667
23296.58,828,782,46,46,253,9.8333
23309.47,835,784,51,48,255,9.8
23321.94,831,783,48,46,254,9.6333
23334.36,829,781,48,46,254,9.7
23347.71,835,786,49,45,254,9.6667
23360.12,832,783,49,47,254,9.5333
23373.36,831,782,49,46,255,9.6
23385.94,831,783,48,46,253,9.5667
23398.49,834,786,48,47,254,9.5333
23411.2,834,786,48,47,254,9.5
23423.57,833,783,50,46,254,9.4333
23436.77,836,786,50,46,255,9.3667
23449.22,830,783,47,46,254,9.3667
23461.73,834,786,48,46,255,9.3667
23474.23,835,786,49,47,255,9.3333
23486.57,831,783,48,46,254,9.3667
23499.43,832,786,46,47,255,9.3
23511.91,832,783,49,47,254,9.3667
23524.44,834,786,48,45,255,9.3333
23537.03,835,786,49,46,255,9.3
23549.28,832,784,48,47,252,9.2333
23562.13,835,786,49,46,255,9.2667
23574.61,832,783,49,46,253,9.2
23587.14,835,785,50,45,255,8.6333
23599.61,833,786,47,45,255,7.4667
23611.92,831,783,48,43,254,6.1667
23624.81,830,783,47,42,254,4.8333
23637.45,831,783,48,42,253,3.5333
23650.05,834,783,51,43,255,2.7667
23662.53,833,784,49,41,255,2.4667
23674.89,831,778,53,42,253,2.3667
23687.93,835,785,50,41,255,2.2667
23700.38,830,782,48,43,253,2.2333
23713.3,834,786,48,42,254,2.1667
23725.86,832,783,49,42,254,2.1333
23738.4,830,782,48,42,253,2.0667
23751.53,835,785,50,43,255,2.0333
23763.86,832,783,49,42,254,2.0
23777.17,835,786,49,41,254,1.9667
23789.64,831,783,48,42,254,1.9
23802.17,835,786,49,41,255,1.8667
23814.7,834,785,49,42,254,1.8
23827.07,832,783,49,43,254,1.7667
23840.25,831,783,48,42,254,1.7333
23852.75,831,783,48,42,254,1.7333
23865.26,834,786,48,43,254,1.7
23877.74,835,784,51,42,254,1.7
23890.06,830,780,50,42,253,1.6667
23902.9,831,785,46,41,254,1.6333
23915.35,831,783,48,42,254,1.6
23927.9,828,787,41,43,253,1.6
23940.42,834,787,47,43,255,1.6
23952.71,831,783,48,43,254,1.6
23965.56,835,786,49,42,255,1.5667
23978.04,831,783,48,42,254,1.5667
23990.61,834,786,48,43,254,1.5333
24003.13,835,786,49,42,254,1.5333
24015.39,834,782,52,42,254,1.5333
24028.3,834,784,50,42,255,1.5
24040.82,830,783,47,41,254,1.5333
24053.36,831,791,40,41,255,1.5
24065.88,834,786,48,42,255,1.5
24078.2,831,783,48,41,253,1.4667
24091.02,835,786,49,43,255,1.4667
24103.57,832,783,49,42,254,1.4333
24116.04,835,785,50,42,254,1.4333
24128.51,834,786,48,42,254,1.4333
24140.81,832,783,49,42,254,1.4333
24153.71,835,785,50,42,255,1.4
24166.17,831,783,48,43,254,1.3667
24178.7,835,786,49,43,253,1.3667
24191.22,834,786,48,42,254,1.3333
24203.57,830,783,47,41,253,1.3667
24216.32,831,787,44,42,254,1.3333
24228.78,831,782,49,42,254,1.3333
24241.34,836,786,50,42,254,1.3333
24253.85,836,787,49,41,255,1.3
24266.11,831,783,48,42,253,1.3
24279.03,835,786,49,42,255,1.3
24291.51,830,783,47,42,254,1.3
24304.03,835,784,51,41,255,1.3
24316.6,833,785,48,42,255,1.3
24329.17,831,783,48,42,253,1.3
24342.08,836,780,56,43,255,1.2667
24354.57,831,782,49,43,253,1.2667
24369.09,835,785,50,42,255,1.2667
24381.58,831,782,49,43,254,1.2333
24394.18,834,787,47,43,254,1.2333
24406.93,836,786,50,41,255,1.2333
24419.22,832,783,49,41,254,1.2333
24432.32,831,784,47,41,255,1.2333
24444.9,831,783,48,41,253,1.2
24457.42,834,782,52,41,254,1.2
24469.93,835,785,50,42,255,1.2
24482.21,830,783,47,42,253,1.1667
24495.24,834,784,50,42,255,1.1667
24507.74,831,782,49,42,254,1.1667
24520.4,835,786,49,41,255,1.1667
24532.84,835,786,49,41,255,1.1667
24545.15,831,783,48,41,254,1.1667
24557.86,841,787,54,42,256,1.1333
24570.39,831,783,48,42,254,1.1333
24582.96,834,785,49,41,254,1.1333
24595.49,834,786,48,42,255,1.1333
24607.8,831,782,49,42,254,1.1
24620.83,835,785,50,42,255,1.1333
24633.32,831,782,49,41,254,1.1333
24646.36,834,785,49,41,255,1.1
24659.42,831,783,48,42,254,1.1333
24673.56,833,783,50,41,254,1.1
24686.31,832,783,49,42,254,1.1
24702.9,831,783,48,41,254,1.1
24716.34,830,784,46,42,254,1.1
24728.87,832,784,48,43,253,1.0667
24741.53,831,783,48,42,254,1.0667
24754.08,819,776,43,41,251,1.0667
24766.02,824,779,45,42,253,1.0333
24778.73,826,783,43,42,254,1.0667
24790.71,823,780,43,42,251,1.0667
24803.54,827,784,43,42,254,1.0333
24815.33,824,779,45,41,253,1.0333
24827.24,828,785,43,42,254,1.0333
24839.14,827,785,42,42,254,1.0333
24850.96,823,779,44,41,253,1.0333
24863.22,831,780,51,42,254,1.0333
24875.09,822,779,43,41,252,1.0333
24886.97,827,785,42,42,254,1.0333
24898.82,828,784,44,42,254,1.0333
24910.52,824,780,44,42,253,1.0333
24923.15,827,784,43,41,254,1.0333
24935.1,828,783,45,42,254,1.0333
24946.85,829,784,45,41,254,1.0
24959.32,828,784,44,41,254,1.0333
24971.05,823,779,44,42,252,1.0
24982.95,830,784,46,41,254,1.0
24994.93,828,783,45,40,254,1.0
25006.68,824,780,44,41,253,1.0
25018.88,828,784,44,42,255,0.9667
25030.8,825,780,45,41,253,0.9667
25042.7,828,784,44,42,254,0.9667
25054.61,829,784,45,41,254,0.9667
25066.24,825,779,46,42,253,0.9667
25078.87,828,784,44,41,254,0.9667
25090.74,828,783,45,42,254,0.9667
25102.51,828,784,44,42,255,0.9667
25114.99,828,784,44,42,254,0.9333
25126.73,824,780,44,42,253,0.9667
25138.69,827,783,44,41,254,0.9667
25150.59,829,784,45,42,254,0.9333
25162.41,823,780,43,41,252,0.9667
25174.79,830,785,45,41,254,0.9333
25186.69,824,780,44,40,252,0.9333
25198.55,828,783,45,42,254,0.9333
25210.45,828,783,45,42,253,0.9333
25222.22,824,781,43,42,253,0.9333
25234.78,827,784,43,41,254,0.9333
25246.68,828,784,44,41,253,0.9333
25258.39,826,784,42,41,255,0.9333
25270.32,828,784,44,42,255,0.9333
25281.95,822,780,42,42,252,0.9
25294.17,828,784,44,42,254,0.9
25306.13,829,784,45,43,254,0.9
25317.81,824,779,45,42,253,0.9
25330.61,828,784,44,41,254,0.9
25342.4,823,779,44,42,252,0.9
25354.34,827,785,42,42,254,0.9
25366.25,826,783,43,42,254,0.9
25377.97,824,779,45,42,253,0.8667
25390.21,827,785,42,41,254,0.9
25402.1,825,779,46,41,253,0.9
25413.98,826,782,44,42,254,0.8667
25425.89,827,785,42,43,254,0.9
25437.65,824,781,43,42,253,0.8667
25450.17,834,787,47,42,254,0.8667
25462.59,833,784,49,43,254,0.8667
25475.28,831,781,50,41,255,0.8667
25488.62,835,787,48,42,255,0.8667
25501.36,834,782,52,42,254,0.8667
25515.11,835,786,49,42,255,0.8667
25527.9,833,784,49,42,254,0.8667
25540.75,835,787,48,43,254,0.8667
25553.86,834,786,48,43,255,0.8667
25566.39,827,788,39,42,254,0.8667
25579.26,834,785,49,42,255,0.8333
25591.77,832,783,49,43,254,0.8333
25604.37,836,786,50,42,255,0.8333
25616.85,832,785,47,43,254,0.8333
25629.16,831,783,48,42,254,0.8
25642.01,834,785,49,41,255,0.8333
25654.64,832,785,47,42,254,0.8333
25667.46,836,785,51,41,255,0.8333
25680.21,836,786,50,42,255,0.8
25692.83,830,781,49,41,253,0.8333
25706.15,834,785,49,42,255,0.8
25719.16,833,783,50,42,254,0.8
25732.62,837,786,51,41,255,0.8333
25745.39,830,784,46,42,255,0.8
25758.15,831,782,49,42,254,0.8
25771.6,836,785,51,42,255,0.8
25784.06,833,783,50,43,254,0.8
25797.19,835,785,50,41,255,0.8333
25809.7,831,783,48,41,254,0.8333
25822.29,835,785,50,42,255,0.8
25834.89,834,786,48,42,254,0.8
25847.27,832,782,50,41,253,0.8
25860.1,835,786,49,41,255,0.8
25872.6,831,777,54,41,254,0.8
25885.24,835,784,51,41,254,0.8
25897.74,834,786,48,42,254,0.8
25910.05,831,782,49,43,254,0.8
25922.9,835,786,49,42,255,0.7667
25935.48,831,782,49,41,253,0.7667
25948.03,835,786,49,41,255,0.8
25960.55,836,787,49,42,254,0.7667
25973.17,832,782,50,42,254,0.8
25986.38,836,786,50,42,255,0.7667
25999.13,833,783,50,41,254,0.7333
26012.21,835,786,49,42,255,0.7667
26025.05,834,784,50,42,254,0.7667
26037.82,832,783,49,42,254,0.7667
26051.49,836,782,54,42,254,0.7667
26064.16,833,783,50,42,254,0.7667
26077.31,836,784,52,41,254,0.7667
26089.8,831,782,49,43,253,0.7667
26102.4,835,787,48,42,255,0.7667
26114.96,835,785,50,41,255,0.7667
26127.28,832,782,50,42,253,0.7667
26140.11,834,786,48,43,254,0.7667
26152.63,831,783,48,42,254,0.7667
26165.2,835,787,48,43,254,0.7333
26177.71,831,785,46,44,254,0.7333
26190.07,832,783,49,42,254,0.7333
26202.99,835,786,49,43,255,0.7333
26215.54,830,784,46,42,254,0.7333
26228.2,835,785,50,42,254,0.7333
26240.7,833,785,48,42,255,0.7333
26252.99,832,782,50,42,254,0.7333
26266.17,837,786,51,41,255,0.7333
26278.89,833,782,51,42,254,0.7333
26291.89,836,785,51,42,255,0.7333
26304.67,834,783,51,42,254,0.7333
26317.41,831,784,47,42,254,0.7333
26331.53,836,787,49,42,254,0.7333
26344.19,834,783,51,42,254,0.7333
26357.65,835,787,48,43,254,0.7333
26370.39,832,784,48,42,253,0.7333
26382.97,834,781,53,43,253,0.7333
26395.95,834,785,49,42,255,0.7333
26408.39,830,782,48,43,254,0.7333
26421.6,833,784,49,43,255,0.7333
26434.18,831,781,50,42,253,0.7
26447.54,832,785,47,43,253,0.7
26460.12,831,782,49,41,254,0.7
26472.66,830,780,50,43,253,0.7
26486.07,834,784,50,43,254,0.7
26498.51,831,783,48,42,253,0.7
26511.81,834,783,51,43,254,0.7
26524.39,827,780,47,43,253,0.7
26536.99,835,786,49,42,255,0.7
26549.51,830,784,46,42,255,0.7
26561.93,831,782,49,43,253,0.7
26575.16,835,785,50,41,254,0.7
26587.79,831,781,50,42,253,0.7
26600.39,834,785,49,41,254,0.7
26612.97,832,785,47,42,254,0.7
26625.34,829,782,47,42,253,0.7
26638.61,833,783,50,42,254,0.7
26651.19,830,780,50,42,253,0.6667
26664.37,832,780,52,43,253,0.7
26683.79,829,781,48,42,253,0.7
26697.01,833,785,48,42,254,0.7
26709.55,832,783,49,42,254,0.7
26722.69,825,780,45,42,253,0.6667
26736.14,834,785,49,42,254,0.7
26748.76,831,781,50,42,254,0.6667
26761.85,830,782,48,42,254,0.6667
26774.91,829,781,48,43,253,0.6667
26791.23,831,783,48,43,254,0.6667
26803.82,831,780,51,41,253,0.6333
26816.44,830,782,48,42,254,0.6667
26829.23,834,783,51,42,254,0.6667
26841.75,830,781,49,43,253,0.6667
26855.2,835,783,52,43,255,0.6667
26867.76,831,782,49,42,253,0.6667
26880.36,828,780,48,42,253,0.6667
26893.04,830,784,46,41,255,0.6667
26905.33,830,780,50,42,253,0.6667
26917.94,832,784,48,42,254,0.6667
26930.3,828,781,47,41,253,0.6667
26942.74,833,784,49,42,254,0.6667
26955.21,832,784,48,43,254,0.6667
26971.48,831,784,47,42,254,0.6333
26984.9,833,785,48,42,254,0.6667
26998.87,831,780,51,42,254,0.6333
27012.06,835,783,52,42,254,0.6667
27024.56,832,782,50,42,252,0.6333
27037.29,834,783,51,42,254,0.6333
27049.86,831,782,49,41,253,0.6333
27062.54,828,780,48,42,252,0.6333
27076.63,834,783,51,42,256,0.6333
27089.26,830,782,48,41,253,0.6333
27102.56,833,784,49,42,254,0.6333
27115.1,834,783,51,43,255,0.6333
27127.9,834,784,50,43,254,0.6333
27140.84,830,782,48,40,253,0.6333
27154.9,831,781,50,42,254,0.6333
27167.57,834,779,55,42,253,0.6333
27180.07,830,781,49,42,254,0.6333
27192.93,834,783,51,41,254,0.6333
27205.49,831,782,49,43,253,0.6333
27218.01,831,781,50,41,254,0.6333
27230.63,830,781,49,42,253,0.6333
27243.24,830,781,49,42,253,0.6333
27256.46,832,785,47,42,255,0.6333
27268.94,831,781,50,41,254,0.6
27281.53,829,780,49,41,254,0.6333
27294.42,831,790,41,41,254,0.6333
27306.85,830,779,51,41,252,0.6333
27319.97,835,785,50,42,255,0.6333
27332.47,830,781,49,42,253,0.6333
27345.02,833,783,50,43,254,0.6
27357.5,833,782,51,41,253,0.6
27370.0,829,782,47,43,253,0.6333
27382.92,834,779,55,43,255,0.6
27395.4,831,781,50,41,253,0.6
27407.95,833,784,49,43,254,0.6
27420.48,834,785,49,41,254,0.6
27432.71,830,780,50,41,253,0.6
27445.74,833,785,48,43,254,0.6
27458.21,833,781,52,42,254,0.6
27470.76,834,785,49,42,254,0.6
27483.22,832,785,47,42,255,0.6
27495.55,829,780,49,42,253,0.6
27508.4,832,783,49,42,255,0.6
27520.89,829,782,47,42,253,0.6
27533.39,831,785,46,41,254,0.6
27545.97,829,785,44,42,252,0.6
27558.31,831,781,50,43,253,0.6
27571.14,834,784,50,42,255,0.6
27583.63,830,782,48,42,253,0.6
27596.18,832,784,48,42,254,0.6
27608.64,833,784,49,42,254,0.5667
27621.0,831,781,50,42,253,0.6
27633.83,832,783,49,41,254,0.6
27646.3,830,780,50,42,253,0.6
27658.87,834,784,50,42,254,0.5667
27671.36,831,783,48,42,253,0.5667
27683.77,831,782,49,43,253,0.5667
27696.59,834,784,50,42,254,0.5667
27709.06,830,781,49,42,253,0.5667
27721.59,834,784,50,42,254,0.5667
27734.5,830,785,45,42,254,0.5667
27747.06,827,778,49,41,252,0.5667
27760.38,831,782,49,41,253,0.5667
27773.17,831,780,51,42,253,0.6
27786.71,828,780,48,42,252,0.5667
27799.92,828,778,50,42,252,0.5667
27812.31,827,780,47,42,253,0.5667
27824.59,827,781,46,42,253,0.5667
27836.86,828,780,48,42,252,0.5667
27851.0,828,786,42,42,253,0.5667
27864.24,828,781,47,42,253,0.5667
27876.64,833,785,48,42,254,0.5667
27888.92,832,782,50,42,254,0.5667
27900.67,823,779,44,42,253,0.5667
27912.86,827,783,44,42,254,0.5667
27924.73,823,775,48,41,251,0.5667
27936.63,827,783,44,42,254,0.5667
27948.5,828,783,45,42,254,0.5667
27960.2,820,779,41,42,252,0.5667
27972.75,826,783,43,40,254,0.5667
27984.65,819,775,44,41,250,0.5667
28001.02,823,778,45,42,251,0.5667
28016.11,827,782,45,40,254,0.5667
28028.15,824,778,46,41,252,0.5667
28040.59,826,783,43,42,254,0.5667
28052.93,823,779,44,41,251,0.5667
28066.21,826,784,42,42,254,0.5667
28078.18,827,782,45,42,254,0.5667
28090.1,820,778,42,42,251,0.5667
28102.86,818,775,43,41,253,0.5667
28115.68,824,779,45,42,252,0.5667
28128.24,827,782,45,41,254,0.5667
28140.15,821,778,43,42,252,0.5333
28153.75,822,779,43,41,252,0.5333
28166.38,828,782,46,40,254,0.5333
28178.25,822,778,44,41,253,0.5333
28190.85,820,777,43,42,251,0.5333
28203.48,826,777,49,42,252,0.5667
28215.32,823,777,46,42,253,0.5333
28228.21,828,783,45,42,254,0.5333
28240.43,823,778,45,43,253,0.5333
28253.62,827,783,44,42,253,0.5333
28265.55,820,778,42,41,252,0.5333
28277.61,823,777,46,41,252,0.5333
28290.59,816,775,41,42,251,0.5333
28303.38,820,778,42,42,252,0.5667
28315.47,826,782,44,42,254,0.5333
28327.38,821,777,44,42,252,0.5333
28339.38,828,783,45,42,254,0.5333
28351.25,825,783,42,42,254,0.5333
28363.17,823,778,45,42,252,0.5333
28376.14,819,776,43,41,252,0.5333
28388.6,823,778,45,42,253,0.5333
28400.55,821,779,42,40,252,0.5333
28413.32,828,782,46,41,254,0.5333
28425.27,820,775,45,41,252,0.5333
28438.16,827,783,44,42,253,0.5333
28450.05,819,779,40,41,252,0.5333
28462.08,823,777,46,42,252,0.5333
28474.61,827,783,44,42,254,0.5333
28486.73,821,778,43,42,252,0.5333
28499.01,827,782,45,42,254,0.5333
28510.84,826,781,45,42,252,0.5333
28522.7,828,784,44,41,254,0.5333
28534.76,826,783,43,42,254,0.5333
28546.63,825,778,47,42,253,0.5333
28559.19,828,783,45,42,254,0.5333
28571.05,828,782,46,42,254,0.5333
28582.8,822,779,43,42,252,0.5
28595.82,833,785,48,42,254,0.5333
28608.21,826,776,50,42,254,0.5333
28621.23,834,783,51,41,254,0.5333
28633.66,834,786,48,41,254,0.5333
28646.26,830,783,47,43,253,0.5333
28659.61,835,785,50,42,254,0.5333
28672.33,830,781,49,41,254,0.5333
28687.02,834,784,50,43,255,0.5333
28699.48,830,782,48,42,253,0.5
28711.86,828,782,46,41,253,0.5333
28724.91,828,782,46,41,252,0.5
28737.7,829,781,48,41,253,0.5
28750.21,832,784,48,43,254,0.5
28762.55,827,778,49,41,252,0.5
28775.76,827,781,46,42,252,0.5
28788.56,830,784,46,43,256,0.5
28800.92,823,780,43,42,253,0.5
28813.28,822,778,44,42,252,0.5333
28826.07,824,780,44,42,251,0.5
28839.2,827,783,44,41,254,0.5
28851.21,828,784,44,41,254,0.5
28863.18,824,778,46,42,252,0.5
28876.03,828,782,46,41,254,0.5
28887.9,824,779,45,42,253,0.5
28900.49,828,784,44,41,254,0.5
28912.33,824,779,45,42,252,0.5333
28924.47,823,777,46,42,253,0.5
28937.18,828,784,44,41,254,0.5
28949.09,829,778,51,42,252,0.5
28961.99,827,784,43,40,254,0.5
28973.87,829,779,50,42,253,0.5
28985.76,818,779,39,42,251,0.5
28998.59,824,779,45,42,251,0.5333
29011.01,825,779,46,41,253,0.5
29023.58,828,784,44,41,254,0.5
29035.65,823,780,43,42,254,0.5
29048.3,824,780,44,42,252,0.5
29060.94,828,784,44,42,254,0.5
29072.8,822,780,42,41,251,0.5
29085.11,822,778,44,42,252,0.5
29097.9,827,784,43,42,254,0.5
29109.76,825,779,46,41,253,0.5
29122.16,829,784,45,41,254,0.5
29134.36,825,780,45,42,252,0.5
29146.8,820,779,41,40,254,0.5
29159.13,829,783,46,42,254,0.5
29171.03,823,778,45,42,252,0.5
29183.54,826,781,45,41,251,0.5
29195.65,822,778,44,41,252,0.5
29208.32,823,778,45,42,252,0.5
29221.01,819,777,42,43,251,0.5
29233.85,829,783,46,42,254,0.5
29246.32,826,783,43,41,254,0.5
29258.31,825,780,45,42,253,0.5
29271.04,822,779,43,41,252,0.5
29283.51,829,781,48,41,253,0.5
29295.48,824,779,45,41,253,0.5
29307.91,822,777,45,42,252,0.5
29320.66,822,779,43,42,253,0.4667
29333.2,825,784,41,42,254,0.5
29345.11,828,784,44,42,254,0.4667
29361.15,821,775,46,43,251,0.4667
29376.52,828,783,45,41,252,0.4667
29392.79,829,784,45,41,254,0.4667
29404.66,828,782,46,41,254,0.4667
29416.39,823,773,50,43,254,0.4667
29429.41,828,784,44,42,254,0.5
29441.28,828,782,46,42,254,0.4667
29453.25,823,783,40,41,254,0.5
29465.13,828,782,46,42,254,0.5
29476.92,824,778,46,41,253,0.4667
29489.27,828,783,45,41,254,0.4667
29501.23,830,782,48,43,253,0.4667
29513.64,830,781,49,42,252,0.5
29527.27,830,782,48,42,253,0.5
29544.96,827,779,48,41,253,0.4667
29558.95,830,780,50,42,254,0.4667
29571.51,825,778,47,42,253,0.4667
29584.98,831,781,50,41,252,0.4667
29598.5,827,780,47,42,253,0.4667
29611.24,819,775,44,41,251,0.4667
29623.58,823,777,46,43,251,0.4667
29636.46,820,779,41,41,253,0.4667
29648.96,821,778,43,42,252,0.4667
29661.07,824,778,46,41,253,0.4667
29674.13,824,779,45,42,252,0.4667
29686.17,828,784,44,42,254,0.4667
29698.09,827,782,45,42,254,0.4667
29710.24,825,779,46,41,252,0.4667
29723.07,824,775,49,41,252,0.4667
29735.13,823,778,45,42,252,0.4667
29748.82,829,783,46,42,254,0.4667
29760.76,828,784,44,41,254,0.4667
29772.68,824,779,45,42,253,0.4667
29786.3,826,783,43,41,254,0.4667
29798.23,828,783,45,41,254,0.4667
29810.23,823,779,44,42,252,0.4667
29823.17,828,784,44,41,254,0.4667
29835.61,823,780,43,41,253,0.4667
29847.74,826,784,42,42,254,0.4667
29859.66,828,783,45,41,254,0.4667
29871.58,825,778,47,43,252,0.4667
29884.32,827,784,43,42,254,0.4667
29896.28,822,777,45,42,253,0.4667
29908.22,829,784,45,41,254,0.4667
29920.12,828,783,45,42,253,0.4667
29931.87,825,778,47,42,252,0.4667
29944.21,829,783,46,41,254,0.4667
29956.19,822,779,43,42,252,0.4667
29968.1,826,783,43,43,254,0.4667
29979.98,827,783,44,42,254,0.4667
29991.86,825,779,46,41,252,0.4667
30004.3,827,783,44,40,254,0.4667
30016.26,820,779,41,42,252,0.4667
30028.17,827,783,44,43,254,0.4667
30040.05,829,784,45,42,255,0.4667
30051.76,825,780,45,42,254,0.4667
30064.39,829,782,47,41,254,0.4667
30076.31,828,782,46,41,253,0.4667
30088.15,826,779,47,41,254,0.4667
30100.37,825,781,44,43,252,0.4667
30112.37,823,777,46,41,252,0.4667
30124.68,826,783,43,42,254,0.4667
30136.71,828,784,44,42,253,0.4667
30148.67,823,779,44,40,252,0.4667
30161.05,828,784,44,42,254,0.4667
30172.96,825,780,45,41,252,0.4667
30184.97,828,783,45,42,255,0.4667
30198.37,828,784,44,42,254,0.4333
30210.24,828,776,52,41,253,0.4667
30222.25,827,784,43,43,254,0.4667
30234.16,828,784,44,41,253,0.4333
30246.01,819,780,39,41,253,0.4333
30258.56,826,783,43,41,254,0.4667
30270.45,829,783,46,42,255,0.4333
30282.16,824,786,38,42,253,0.4333
30295.54,825,784,41,42,254,0.4333
30307.47,833,781,52,42,254,0.4667
30319.99,835,784,51,43,254,0.4667
30332.8,834,785,49,42,255,0.4333
30345.19,831,782,49,42,253,0.4333
30359.52,834,785,49,42,254,0.4333
30372.05,825,782,43,43,252,0.4333
30384.65,831,781,50,42,253,0.4667
30398.35,833,784,49,42,254,0.4333
30410.87,831,782,49,42,253,0.4667
30423.88,834,783,51,42,255,0.4333
30436.4,835,784,51,42,254,0.4333
30448.75,831,782,49,43,254,0.4333
30461.61,831,792,39,41,255,0.4333
30474.13,831,783,48,42,253,0.4667
30486.95,831,780,51,42,255,0.4333
30500.1,833,786,47,42,254,0.4333
30512.49,829,783,46,42,254,0.4333
30525.9,834,786,48,42,254,0.4333
30538.44,831,783,48,42,254,0.4333
30550.85,833,777,56,43,254,0.4333
30564.06,834,786,48,43,254,0.4333
30576.66,831,783,48,42,254,0.4333
30589.42,834,787,47,43,255,0.4333
30602.28,833,785,48,43,254,0.4667
30614.64,830,783,47,41,254,0.4333
30627.98,835,786,49,42,255,0.4333
30640.47,831,784,47,41,254,0.4333
30652.88,831,782,49,42,254,0.4333
30666.36,834,786,48,42,254,0.4333
30678.91,832,783,49,42,254,0.4333
30691.58,835,785,50,42,255,0.4333
30704.18,833,786,47,42,254,0.4333
30716.58,832,783,49,41,254,0.4333
30730.56,835,786,49,41,256,0.4333
30743.15,826,779,47,42,252,0.4333
30759.37,830,780,50,42,253,0.4333
30773.44,829,781,48,42,253,0.4333
30787.57,833,784,49,41,254,0.4333
30800.08,832,783,49,43,254,0.4333
30812.71,819,776,43,40,251,0.4333
30825.23,821,776,45,42,251,0.4333
30837.61,824,779,45,42,252,0.4333
30851.74,825,780,45,42,253,0.4333
30864.05,827,782,45,41,254,0.4333
30875.95,823,783,40,42,252,0.4333
30887.91,824,779,45,42,254,0.4333
30900.61,828,785,43,42,254,0.4333
30912.41,824,780,44,40,253,0.4333
30924.43,827,784,43,42,254,0.4333
30936.46,829,784,45,42,254,0.4333
30948.17,823,777,46,42,254,0.4333
30960.9,828,784,44,40,254,0.4333
30972.78,829,785,44,42,255,0.4
30984.55,825,779,46,43,252,0.4333
30997.73,827,785,42,41,253,0.4333
31009.58,823,779,44,40,253,0.4333
31021.59,828,784,44,42,254,0.4
31033.45,829,783,46,42,254,0.4333
31045.25,821,781,40,42,253,0.4333
31058.01,827,784,43,41,254,0.4333
31070.15,829,783,46,42,254,0.4
31081.91,825,779,46,42,252,0.4
31095.19,828,784,44,42,253,0.4
31107.03,823,779,44,41,253,0.4
31119.01,830,784,46,41,254,0.4333
31130.93,829,784,45,42,254,0.4333
31142.91,825,780,45,41,253,0.4
31155.65,829,784,45,42,254,0.4333
31167.55,828,784,44,42,254,0.4333
31179.36,824,779,45,42,252,0.4
31192.64,829,784,45,41,255,0.4333
31204.48,824,779,45,43,252,0.4333
31216.43,829,784,45,41,254,0.4333
31228.34,827,785,42,42,254,0.4333
31240.17,822,780,42,41,253,0.4
31253.34,831,784,47,43,253,0.4333
31265.22,829,783,46,42,254,0.4
31277.01,824,779,45,43,253,0.4333
31290.2,828,785,43,41,255,0.4
31302.05,823,779,44,43,253,0.4
31314.07,828,784,44,42,254,0.4
31325.98,834,784,50,42,255,0.4
31337.74,823,781,42,42,254,0.4333
31350.45,827,783,44,42,253,0.4
31362.34,829,786,43,42,254,0.4
31374.23,825,779,46,42,253,0.4
31387.83,830,783,47,43,254,0.4
31399.58,823,780,43,41,252,0.4
31411.57,828,784,44,42,254,0.4
31423.59,829,784,45,41,254,0.4
31435.36,825,780,45,41,253,0.4
31448.11,828,783,45,42,254,0.4
31460.0,827,783,44,41,254,0.4333
31471.89,824,778,46,41,252,0.4
31485.03,826,784,42,41,254,0.4333
31496.87,823,776,47,42,252,0.4
31508.92,828,783,45,42,254,0.4
31520.9,827,785,42,41,254,0.4
31532.91,831,783,48,42,253,0.4
31545.59,834,784,50,41,254,0.4333
31558.13,834,785,49,43,254,0.4
31570.52,831,782,49,43,253,0.4
31583.76,835,784,51,42,255,0.4
31596.3,831,781,50,41,254,0.4
31608.8,832,782,50,41,253,0.4
31622.57,835,784,51,44,255,0.4
31635.08,831,780,51,43,253,0.4
31647.95,835,785,50,42,254,0.4
31660.49,834,785,49,42,254,0.4
31672.91,829,781,48,42,253,0.4
31686.46,834,781,53,43,254,0.4
31698.96,831,782,49,42,253,0.4
31711.64,834,785,49,41,254,0.4
31724.65,832,786,46,42,254,0.4
31737.14,831,781,50,42,253,0.4
31750.65,835,784,51,42,254,0.4
31763.19,831,780,51,43,254,0.4
31776.06,831,782,49,41,253,0.4
31789.66,835,784,51,42,254,0.4
31802.1,830,782,48,42,253,0.4
31815.07,834,784,50,42,254,0.4
31827.6,833,785,48,42,254,0.4
31840.0,830,782,48,43,253,0.4
31853.65,835,786,49,42,255,0.4
31866.15,832,782,50,41,253,0.4
31878.86,835,785,50,42,255,0.4
31891.82,833,786,47,42,255,0.4
31904.41,831,783,48,42,254,0.4
31917.73,835,784,51,42,254,0.4
31930.27,831,782,49,42,254,0.4
31942.7,830,781,49,42,253,0.4
31956.18,831,788,43,42,255,0.4
31968.72,831,782,49,42,254,0.4
31981.38,835,785,50,41,255,0.4
31993.94,834,785,49,42,255,0.4
32006.37,831,783,48,41,253,0.4
32020.1,835,787,48,42,254,0.4
32032.58,829,782,47,42,253,0.4
32045.3,824,782,42,42,253,0.4
32058.58,834,783,51,43,254,0.4
32071.14,831,782,49,42,254,0.4
32084.42,835,785,50,42,255,0.4
32096.96,834,785,49,42,254,0.4
32114.97,829,782,47,41,254,0.4
32128.01,834,785,49,42,254,0.4
32140.57,831,782,49,42,254,0.4
32153.84,839,786,53,43,253,0.4
32166.55,831,782,49,42,254,0.4
32179.17,830,780,50,42,253,0.4
32192.73,834,785,49,42,254,0.4
32205.14,830,782,48,42,253,0.4
32218.21,835,784,51,42,255,0.3667
32230.7,834,786,48,41,255,0.4
32243.03,830,782,48,42,251,0.4
32255.9,835,784,51,42,254,0.4
32268.39,831,782,49,42,254,0.4
32281.09,830,781,49,42,254,0.3667
32294.22,835,785,50,42,254,0.4
32306.61,833,782,51,42,254,0.4
32320.05,835,784,51,43,255,0.4
32332.51,829,783,46,42,253,0.3667
32345.02,830,782,48,42,254,0.4
32358.64,834,786,48,42,255,0.3667
32371.12,828,780,48,43,254,0.4
32383.93,834,785,49,43,254,0.4
32397.7,834,785,49,42,254,0.4
32410.08,831,780,51,41,253,0.3667
32422.92,832,786,46,42,254,0.3667
32435.44,831,782,49,41,253,0.3667
32448.13,832,781,51,42,254,0.4
32461.27,834,786,48,42,254,0.3667
32473.63,829,783,46,43,254,0.4
32487.02,835,785,50,42,255,0.4
32499.47,831,781,50,41,253,0.4
32511.85,831,782,49,41,252,0.4
32525.09,835,785,50,43,255,0.3667
32537.65,829,782,47,42,253,0.3667
32550.3,834,784,50,41,255,0.4
32562.88,833,785,48,42,254,0.4
32575.21,831,782,49,43,253,0.3667
32588.39,834,784,50,42,254,0.3667
32600.88,831,782,49,41,254,0.3667
32613.32,831,779,52,42,253,0.3667
32627.07,834,783,51,42,255,0.3667
32639.57,832,783,49,42,251,0.3667
32652.4,833,785,48,42,255,0.4
32664.92,834,785,49,43,254,0.3667
32677.33,831,781,50,42,253,0.3667
32690.36,835,784,51,43,254,0.4
32702.84,830,782,48,42,253,0.4
32715.39,829,780,49,42,253,0.3667
32728.94,835,784,51,42,255,0.3667
32741.38,831,781,50,42,253,0.3667
32754.66,835,785,50,43,255,0.4
32767.17,834,785,49,42,254,0.4
32779.52,831,782,49,42,253,0.3667
32792.32,831,783,48,41,253,0.4
32805.02,831,783,48,42,253,0.3667
32817.83,831,782,49,42,255,0.3667
32830.98,835,785,50,42,254,0.3667
32843.32,829,782,47,43,253,0.3667
32858.28,834,784,50,41,254,0.3667
32870.8,831,781,50,43,253,0.3667
32883.35,830,780,50,41,253,0.3667
32896.93,835,784,51,42,254,0.3667
32909.32,831,783,48,41,254,0.3667
32922.53,833,785,48,42,255,0.3667
32935.08,834,784,50,42,255,0.3667
32947.5,830,781,49,41,254,0.4
32960.3,835,786,49,41,254,0.3667
32972.79,831,782,49,42,254,0.3667
32985.49,832,785,47,42,254,0.3667
32998.53,833,784,49,42,254,0.3667
33010.86,831,782,49,42,254,0.3667
33024.2,833,785,48,42,254,0.3667
33036.75,829,782,47,42,252,0.3667
33049.11,834,780,54,43,252,0.3667
33062.43,833,785,48,43,254,0.3667
33074.91,831,781,50,41,254,0.3667
33087.52,835,784,51,42,254,0.3667
33099.96,834,785,49,42,254,0.3667
33112.25,830,783,47,42,253,0.3667
33125.57,835,783,52,43,255,0.3667
33138.04,831,783,48,42,253,0.3667
33150.42,830,782,48,41,253,0.3667
33164.09,835,785,50,41,255,0.3667
33176.63,831,783,48,42,253,0.3667
33189.37,834,784,50,42,255,0.3667
33201.86,833,784,49,42,255,0.3667
33214.24,828,782,46,42,253,0.3667
33227.29,833,785,48,43,255,0.3667
33239.78,830,782,48,41,253,0.3667
33252.33,831,781,50,42,253,0.3667
33265.98,833,785,48,42,254,0.3667
33278.37,831,781,50,41,253,0.3667
33291.61,834,785,49,41,255,0.3667
33304.13,835,785,50,42,254,0.3667
33316.43,830,781,49,41,253,0.3667
33329.29,834,785,49,41,255,0.3667
33341.78,831,784,47,42,253,0.3667
33354.46,829,781,48,43,254,0.3667
33367.46,834,785,49,42,254,0.3667
33379.81,830,782,48,42,253,0.3667
33392.99,835,785,50,42,254,0.3667
33405.51,834,786,48,42,255,0.3667
33417.82,831,781,50,42,254,0.3667
33430.63,835,785,50,42,255,0.3667
33443.12,831,782,49,41,254,0.3667
33455.84,832,785,47,42,254,0.3667
33468.9,834,785,49,42,254,0.3667
33481.27,830,783,47,42,254,0.3667
33494.65,834,785,49,44,255,0.3667
33507.2,830,784,46,42,254,0.3667
33519.6,832,783,49,41,253,0.3667
33532.81,835,785,50,42,254,0.3667
33545.39,831,783,48,42,254,0.3667
33558.03,831,791,40,42,255,0.3667
33570.54,835,786,49,41,254,0.3667
33582.84,831,782,49,42,254,0.3667
33596.19,834,784,50,44,255,0.3667
33608.68,833,783,50,42,253,0.3667
33621.14,832,783,49,42,254,0.3667
33634.77,836,786,50,42,255,0.3667
33647.25,833,784,49,42,253,0.3667
33659.96,836,785,51,42,255,0.3667
33672.46,836,786,50,42,255,0.3667
33684.85,833,782,51,42,253,0.3667
33697.87,834,785,49,43,255,0.3667
33710.36,831,783,48,41,253,0.3667
33722.95,833,781,52,43,253,0.3667
33736.7,837,787,50,41,256,0.3667
33749.04,832,781,51,42,253,0.3667
33762.29,835,786,49,41,255,0.3667
33774.83,833,786,47,42,255,0.3667
33787.17,831,782,49,42,254,0.3667
33800.02,835,784,51,42,254,0.3667
33812.92,832,783,49,42,254,0.3667
33826.62,831,784,47,41,254,0.3667
33839.89,833,783,50,42,254,0.3667
33852.98,833,784,49,43,254,0.3667
33866.01,832,783,49,42,254,0.3667
33878.59,828,780,48,41,253,0.3667
33891.14,832,783,49,42,254,0.3667
33903.96,830,783,47,42,254,0.3667
33916.36,831,780,51,41,253,0.3667
33929.8,832,782,50,42,254,0.3667
33943.32,828,780,48,40,251,0.3667
33955.38,826,784,42,42,254,0.3667
33967.59,829,784,45,41,254,0.3667
33979.32,823,780,43,42,252,0.3333
33991.29,822,784,38,41,254,0.3667
34003.4,829,784,45,42,255,0.3667
34015.1,826,780,46,42,253,0.3667
34027.76,827,785,42,41,254,0.3667
34039.61,829,784,45,42,254,0.3667
34051.29,825,779,46,42,253,0.3667
34064.38,828,784,44,42,254,0.3667
34076.21,825,780,45,41,252,0.3667
34088.11,828,785,43,42,254,0.3667
34099.93,830,784,46,42,254,0.3667
34111.67,824,780,44,42,253,0.3667
34124.0,826,785,41,41,254,0.3667
34136.11,828,785,43,42,254,0.3667
34147.88,826,779,47,42,252,0.3667
34163.49,823,782,41,42,254,0.3667
34175.85,825,780,45,42,253,0.3667
34187.76,822,785,37,41,253,0.3667
34199.58,828,784,44,42,254,0.3667
34211.4,824,779,45,42,252,0.3667
34223.84,831,790,41,42,255,0.3667
34235.96,830,784,46,42,254,0.3667
34247.75,824,781,43,41,252,0.3667
34260.42,830,786,44,42,254,0.3667
34272.17,824,779,45,41,253,0.3667
34284.14,828,785,43,42,254,0.3667
34296.1,831,791,40,41,254,0.3667
34307.83,826,780,46,42,253,0.3667
34320.69,830,784,46,42,254,0.3667
34332.5,828,783,45,42,255,0.3667
34344.21,825,779,46,42,253,0.3333
34357.35,831,783,48,42,255,0.3667
34369.38,824,779,45,42,252,0.3667
34381.35,830,785,45,41,254,0.3667
34393.21,828,784,44,42,253,0.3667
34404.95,825,781,44,43,253,0.3333
34417.57,828,785,43,41,255,0.3667
34429.43,829,783,46,42,254,0.3333
34441.15,825,778,47,41,253,0.3333
34454.6,828,784,44,41,254,0.3667
34466.32,823,780,43,41,252,0.3333
34478.3,829,784,45,42,254,0.3667
34490.15,829,783,46,41,254,0.3667
34501.81,825,781,44,42,253,0.3333
34514.47,828,785,43,42,254,0.3333
34526.33,829,784,45,42,254,0.3333
34538.06,824,779,45,42,252,0.3333
34551.15,829,785,44,42,255,0.3667
34562.97,826,781,45,41,252,0.3667
34574.94,827,785,42,41,254,0.3333
34586.86,830,782,48,42,255,0.3333
34598.49,823,779,44,41,252,0.3333
34610.9,828,783,45,39,254,0.3333
34622.74,829,784,45,40,254,0.3333
34634.47,822,780,42,42,252,0.3333
34646.7,827,784,43,42,254,0.3667
34658.92,833,783,50,42,254,0.3333
34671.58,833,783,50,42,254,0.3333
34684.56,836,786,50,41,255,0.3667
34697.74,833,784,49,42,254,0.3333
34710.69,832,782,50,42,254,0.3333
34724.38,836,787,49,42,255,0.3667
34737.11,833,782,51,42,254,0.3667
34750.07,834,783,51,42,255,0.3333
34762.63,835,786,49,42,254,0.3333
34775.09,831,783,48,42,254,0.3333
34788.26,835,787,48,41,255,0.3667
34800.77,827,784,43,42,254,0.3333
34813.52,831,783,48,42,255,0.3333
34826.67,835,784,51,42,255,0.3333
34839.07,832,784,48,42,254,0.3333
34855.39,832,783,49,42,254,0.3333
34868.26,831,783,48,42,254,0.3667
34884.84,835,785,50,42,255,0.3667
34897.3,835,784,51,42,255,0.3333
34912.79,831,780,51,43,253,0.3333
34926.52,835,786,49,41,255,0.3333
34938.95,832,783,49,42,254,0.3667
34952.53,836,785,51,42,255,0.3667
34965.01,834,786,48,43,255,0.3333
34977.46,831,783,48,42,254,0.3667
34990.25,834,786,48,41,254,0.3333
35002.77,836,785,51,42,255,0.3667
35015.49,824,781,43,42,253,0.3333
35028.77,835,784,51,42,255,0.3333
35041.19,833,783,50,42,254,0.3333
35054.49,836,786,50,43,255,0.3333
35066.9,832,783,49,42,254,0.3333
35079.36,831,782,49,42,253,0.3333
35092.93,835,785,50,42,253,0.3333
35105.45,840,784,56,42,252,0.3333
35118.17,835,786,49,41,255,0.3333
35130.7,835,784,51,41,255,0.3333
35143.13,832,783,49,43,253,0.3333
35156.32,834,786,48,41,255,0.3333
35170.99,835,786,49,42,255,0.3333
35183.84,831,781,50,42,255,0.3333
35197.04,836,785,51,42,255,0.3333
35209.49,834,783,51,42,254,0.3333
35222.91,838,786,52,42,255,0.3333
35235.53,835,785,50,42,255,0.3333
35248.04,831,779,52,43,253,0.3333
35261.59,835,786,49,41,255,0.3333
35274.18,831,785,46,41,254,0.3333
35287.06,836,785,51,41,255,0.3333
35299.72,834,786,48,43,254,0.3333
35312.17,832,783,49,42,254,0.3333
35325.35,836,786,50,43,255,0.3333
35337.92,835,786,49,42,254,0.3333
35350.46,832,782,50,42,254,0.3333
35364.05,834,786,48,42,255,0.3333
35376.64,830,786,44,42,254,0.3333
35389.36,836,785,51,43,255,0.3333
35402.08,835,786,49,42,254,0.3333
35414.57,831,783,48,42,254,0.3333
35427.75,834,786,48,41,255,0.3333
35440.26,833,786,47,42,255,0.3333
35452.78,832,781,51,42,253,0.3
35466.24,832,786,46,42,256,0.3
35478.81,835,785,50,42,255,0.3
35491.52,836,786,50,42,255,0.3
35504.27,835,787,48,42,255,0.3
35516.67,833,783,50,42,253,0.3
35529.75,835,785,50,42,254,0.3
35542.32,831,782,49,42,254,0.3
35555.23,832,783,49,42,253,0.3
35568.44,834,785,49,42,255,0.3
35581.0,833,785,48,42,255,0.3
35593.68,835,786,49,41,255,0.3
35606.68,835,785,50,42,255,0.3
35619.09,832,783,49,42,254,0.3
35632.33,836,786,50,42,254,0.3
35644.93,827,784,43,42,251,0.3
35657.45,832,783,49,41,254,0.3
35671.35,836,785,51,41,255,0.3
35683.81,831,780,51,42,254,0.3
35696.61,836,787,49,42,255,0.3
35709.1,834,786,48,42,254,0.3
35721.47,832,783,49,42,253,0.2667
35734.59,836,786,50,42,256,0.3
35747.08,832,783,49,42,254,0.3
35759.65,831,780,51,42,253,0.3
35773.12,835,784,51,42,255,0.2667
35785.55,831,782,49,42,253,0.2667
35798.82,834,785,49,41,255,0.2333
35811.31,833,786,47,43,254,0.2
35823.76,831,780,51,43,254,0.1667
35836.64,835,786,49,42,255,0.1
35849.11,832,784,48,42,254,0.0667
35861.73,835,786,49,42,253,0.0333
35874.66,835,786,49,42,255,0.0
35886.97,832,782,50,42,254,0.0
35900.25,834,784,50,42,254,0.0
35912.77,836,786,50,42,255,0.0
35925.1,832,782,50,42,254,0.0333
35937.94,835,785,50,42,255,0.0333
35950.41,831,783,48,42,253,0.0333
35963.13,835,786,49,41,255,0.0333
35976.12,835,787,48,42,255,0.0
35988.44,831,782,49,42,254,0.0
36001.87,835,785,50,42,255,0.0
36014.3,832,783,49,42,254,0.0
36026.72,831,781,50,42,253,0.0
36040.13,833,786,47,43,254,0.0
36052.65,832,783,49,42,254,0.0
36065.24,834,784,50,43,254,0.0
36077.72,841,783,58,44,255,0.0
36090.1,834,783,51,43,253,0.0
36103.4,835,786,49,42,255,0.0
36115.9,834,783,51,42,254,0.0
36128.33,832,782,50,42,253,-0.0333
36141.57,836,786,50,42,255,0.0
36154.1,830,782,48,41,254,0.0
36167.1,835,784,51,41,255,0.0
36179.62,834,786,48,42,254,0.0
36192.01,832,783,49,42,254,0.0
36205.12,835,786,49,42,255,0.0
36217.61,831,783,48,41,254,0.0
36230.2,829,781,48,43,253,0.0
36244.14,835,784,51,42,255,-0.0333
36256.87,835,776,59,43,252,0.0
36270.33,837,787,50,42,255,0.0
36282.82,832,783,49,42,254,0.0
36295.29,831,783,48,43,254,0.0
36308.96,834,784,50,42,254,0.0
36321.43,831,783,48,42,253,0.0
36334.24,835,786,49,41,255,0.0
36346.83,835,786,49,43,255,0.0
36359.13,833,783,50,41,253,0.0
36372.12,834,787,47,42,254,0.0
36384.62,831,788,43,42,255,0.0
36397.19,832,782,50,43,253,0.0
36410.89,836,785,51,42,255,0.0
36423.31,830,783,47,43,254,0.0
36436.83,835,787,48,42,255,0.0
36449.28,831,784,47,43,254,0.0
36461.64,831,783,48,42,253,0.0
36475.06,836,784,52,42,255,0.0
36487.61,831,783,48,41,254,0.0
36500.18,834,785,49,43,255,0.0
36512.67,835,785,50,42,254,0.0
36525.01,832,783,49,43,253,0.0
36538.42,836,786,50,41,255,0.0
36550.93,832,783,49,42,253,-0.0333
36563.55,832,779,53,42,253,0.0
36576.89,833,787,46,42,255,-0.0333
36589.28,831,783,48,42,254,0.0
36602.79,834,785,49,41,254,0.0
36615.28,829,782,47,42,254,0.0
36627.87,831,782,49,42,252,0.0
36641.06,832,785,47,42,254,0.0
36653.58,834,779,55,42,254,0.0
36666.24,835,786,49,42,254,0.0
36678.79,834,785,49,41,255,0.0
36691.17,830,782,48,43,254,0.0
36704.42,835,785,50,42,255,0.0
36716.88,832,783,49,43,254,0.0
36729.32,832,783,49,42,254,0.0333
36743.06,835,784,51,41,255,0.0
36755.59,831,782,49,42,254,0.0
36768.41,836,786,50,42,255,0.0
36780.88,836,784,52,42,255,0.0
36793.19,832,782,50,42,254,0.0
36806.25,836,785,51,42,255,0.0
36818.79,831,783,48,42,253,0.0
36831.42,830,782,48,42,254,0.0333
36844.79,835,785,50,42,255,0.0
36857.17,832,781,51,43,253,0.0
36869.97,831,787,44,41,255,0.0
36883.02,834,786,48,43,255,0.0
36895.83,827,780,47,42,253,0.0
36909.53,830,780,50,42,253,0.0
36922.91,832,787,45,42,254,0.0
36936.71,833,784,49,42,254,0.0333
36949.35,832,782,50,42,254,0.0333
36962.54,833,783,50,42,254,0.0
36975.13,824,780,44,42,253,0.0
36987.43,825,780,45,42,253,0.0333
37000.36,827,784,43,42,254,0.0
37012.34,828,785,43,41,254,0.0333
37024.24,830,783,47,41,254,0.0333
37036.07,825,779,46,42,252,0.0667
37048.5,827,784,43,42,253,0.1333
37060.4,827,784,43,41,255,0.2333
37072.29,825,780,45,42,253,0.4
37084.86,829,784,45,42,254,0.6667
37096.65,823,779,44,42,253,1.0
37108.63,830,783,47,41,254,1.1667
37120.55,829,785,44,42,254,1.1333
37134.95,824,780,44,42,252,1.0333
37147.34,827,784,43,42,253,0.9333
37159.23,820,779,41,42,253,0.9
37171.11,827,785,42,42,254,0.9
37183.0,827,785,42,41,254,0.9333
37194.77,824,776,48,41,255,0.9667
37206.8,829,784,45,42,254,0.9667
37218.7,828,784,44,41,254,0.9
37230.47,825,780,45,42,253,0.9
37242.9,828,784,44,41,254,0.8667
37254.73,829,782,47,42,254,0.9
37266.41,826,776,50,42,253,0.9
37279.42,828,785,43,42,255,0.9333
37291.25,823,776,47,41,252,0.9333
37303.21,829,779,50,42,254,0.9333
37315.12,828,784,44,42,254,0.9333
37326.83,825,779,46,42,252,0.9333
37339.21,826,777,49,43,254,0.9333
37351.09,829,784,45,42,255,0.9333
37362.87,824,779,45,41,253,0.9333
37375.12,823,784,39,41,254,0.9333
37387.03,828,785,43,42,252,0.9333
37398.81,825,781,44,41,254,0.9333
37411.04,831,783,48,43,255,0.9667
37422.76,823,779,44,41,252,0.9667
37434.76,827,784,43,43,255,1.0
37446.64,820,784,36,42,254,1.0333
37458.37,824,780,44,42,253,1.0667
37471.06,828,784,44,42,254,1.1333
37482.91,828,784,44,41,255,1.1333
37494.64,823,779,44,42,253,1.2
37507.77,828,784,44,41,254,1.3667
37519.65,823,780,43,42,252,1.7
37531.58,829,784,45,42,254,1.9
37543.46,829,784,45,42,254,2.0
37555.2,823,781,42,43,253,2.1333
37567.85,828,784,44,42,254,2.3
37579.71,828,782,46,42,254,2.6
37591.52,820,778,42,43,252,3.5
37604.87,827,784,43,43,254,4.8333
37616.79,823,779,44,43,253,5.5333
37628.75,827,784,43,44,253,5.9667
37640.62,828,784,44,43,254,6.0667
37652.3,822,781,41,44,253,6.2333
37665.02,830,785,45,43,254,6.4
37676.89,827,783,44,44,254,6.5667
37688.63,831,782,49,43,254,6.7333
37701.37,835,787,48,45,254,6.9
37713.85,830,782,48,45,253,7.0
37726.52,831,784,47,44,255,7.1333
37739.58,833,786,47,43,255,7.2333
37751.93,832,783,49,45,255,7.3
37765.27,834,785,49,44,255,7.4
37777.73,831,783,48,44,254,7.6667
37790.13,830,781,49,45,253,7.8667
37803.42,837,787,50,45,255,8.0333
37815.92,831,783,48,45,254,8.2333
37828.52,836,786,50,45,255,8.3667
37841.02,831,780,51,46,255,8.6
37853.34,832,782,50,47,254,8.7667
37866.59,835,785,50,46,255,9.0333
37879.08,831,783,48,46,254,9.3
37891.51,832,784,48,47,254,9.5
37905.3,835,784,51,45,255,9.7667
37917.79,832,781,51,47,254,10.0333
37930.55,835,785,50,46,255,10.0667
37943.05,833,786,47,46,255,10.1333
37955.42,832,783,49,47,254,10.2667
37968.39,835,786,49,47,255,10.3333
37980.87,831,782,49,48,254,10.3667
37993.48,831,782,49,49,253,10.4333
38006.81,836,785,51,48,255,10.5333
38019.18,831,781,50,47,254,10.6667
38032.35,838,786,52,48,255,10.5667
38044.89,835,786,49,48,255,10.5667
38057.23,832,783,49,47,255,10.7
38070.14,835,784,51,48,254,10.6667
38082.6,833,783,50,47,254,10.5667
38095.3,831,783,48,47,255,10.8
38108.36,835,785,50,49,254,10.9667
38120.72,832,783,49,49,254,11.0667
38134.06,833,786,47,48,255,11.2667
38146.63,831,783,48,49,254,11.4667
38159.02,831,783,48,48,253,11.5333
38172.21,835,784,51,50,255,11.6333
38184.76,835,783,52,49,254,11.6667
38197.38,836,785,51,49,255,11.8
38209.88,836,786,50,48,255,12.0333
38222.24,827,782,45,50,254,12.3333
38235.58,835,786,49,50,255,12.4333
38248.08,831,784,47,50,253,12.6333
38260.5,831,781,50,50,253,12.7667
38273.72,835,779,56,51,255,12.8333
38286.26,833,783,50,50,253,12.8
38298.91,833,785,48,51,255,13.1
38311.4,834,785,49,52,255,13.1667
38323.75,831,782,49,50,254,13.3
38336.9,835,787,48,52,255,13.4
38349.36,831,781,50,52,253,13.8
38361.97,830,781,49,51,253,13.8
38375.44,835,785,50,53,254,14.0
38387.81,831,782,49,53,253,14.1667
38400.94,835,785,50,52,255,14.1667
38413.44,833,787,46,52,255,14.5
38425.84,831,782,49,53,253,14.5333
38438.64,834,786,48,53,255,14.4
38451.13,832,782,50,54,253,14.8333
38463.79,831,784,47,54,254,14.9333
38476.99,835,785,50,54,255,15.0667
38489.33,831,788,43,53,253,15.2667
38502.74,835,787,48,55,254,15.3667
38515.25,832,782,50,54,253,15.5
38527.61,832,783,49,54,254,15.4333
38540.42,835,786,49,54,255,15.7
38552.93,832,783,49,55,254,15.6333
38565.59,835,787,48,54,254,15.9
38578.46,833,787,46,56,255,15.9333
38590.77,833,783,50,57,254,15.8667
38604.08,835,785,50,56,255,16.0667
38616.6,830,779,51,55,254,16.1667
38628.99,831,783,48,55,253,16.2667
38642.07,835,786,49,56,254,16.3
38654.58,831,783,48,57,254,16.3667
38667.19,835,787,48,58,254,16.5333
38680.06,834,786,48,57,254,16.4667
38692.35,831,783,48,58,254,16.6667
38705.78,835,779,56,56,256,16.7
38718.27,831,783,48,56,254,16.5667
38730.67,831,783,48,57,254,16.3667
38743.79,833,785,48,57,254,16.6333
38756.31,830,783,47,56,254,16.6333
38768.94,835,787,48,58,255,16.7333
38781.44,834,785,49,58,255,16.7333
38793.82,831,783,48,57,254,16.7333
38807.14,833,784,49,58,254,16.9
38819.65,832,783,49,57,254,17.0
38832.04,831,783,48,58,254,17.1
38845.68,835,785,50,58,254,16.9667
38858.18,831,782,49,57,253,17.2667
38870.98,835,785,50,59,255,17.4333
38883.53,835,785,50,59,255,17.3
38896.02,832,783,49,58,253,17.5333
38909.14,835,785,50,59,255,17.6
38921.64,832,777,55,59,254,17.5333
38934.22,831,782,49,58,253,17.9
38947.73,834,786,48,59,254,17.7333
38960.15,830,780,50,60,253,17.9
38973.79,836,785,51,61,254,17.9
38986.47,831,783,48,61,254,17.9333
38998.88,831,781,50,61,254,18.1333
39012.06,835,783,52,60,255,18.2
39024.56,831,782,49,60,254,18.2
39037.21,836,786,50,59,255,18.3667
39049.68,835,786,49,59,255,18.2333
39062.04,831,783,48,60,254,18.2667
39075.34,835,786,49,61,255,18.1333
39087.86,832,783,49,61,253,18.3667
39100.23,827,783,44,61,255,18.5333
39113.85,836,786,50,62,255,18.6333
39126.36,831,783,48,61,253,18.6333
39139.13,836,785,51,63,255,18.6667
39151.62,834,787,47,62,255,18.6333
39163.98,832,783,49,62,254,18.7333
39177.11,835,786,49,62,255,18.7
39189.62,831,783,48,62,254,18.9667
39202.17,831,782,49,62,253,18.9667
39215.74,834,786,48,63,255,18.8333
39228.13,831,776,55,63,253,19.1333
39241.22,835,784,51,63,254,19.3333
39253.72,834,786,48,63,254,18.9667
39266.01,831,782,49,63,253,19.0333
39278.83,836,785,51,63,255,19.2333
39291.33,831,783,48,62,254,19.5667
39304.01,832,786,46,63,254,19.2333
39317.01,839,783,56,64,255,19.2667
39329.34,831,782,49,63,254,19.2
39342.46,835,786,49,63,255,19.4
39355.01,831,786,45,62,254,19.5
39367.31,831,783,48,62,254,19.4667
39380.11,835,786,49,63,255,19.3667
39392.6,832,783,49,63,254,19.1333
39405.29,831,784,47,64,255,19.4667
39418.37,835,786,49,63,255,19.2667
39430.71,831,783,48,64,254,19.4667
39444.02,835,786,49,63,255,19.2667
39456.55,829,783,46,62,254,19.3
39468.91,830,783,47,62,253,19.5
39481.93,837,785,52,63,255,19.1333
39494.43,831,783,48,64,254,19.3333
39507.12,835,785,50,63,255,19.4667
39519.93,835,787,48,62,255,19.2
39532.19,831,779,52,63,254,19.1667
39545.63,834,786,48,64,255,19.1
39558.12,832,782,50,61,254,19.4667
39570.58,831,782,49,63,254,19.3667
39584.15,834,786,48,64,255,19.4333
39596.71,831,783,48,64,254,19.6333
39609.38,834,784,50,65,255,19.5
39621.87,835,786,49,64,255,19.5333
39634.18,832,783,49,63,254,19.5333
39647.27,832,783,49,64,254,19.5333
39660.12,832,783,49,63,252,19.3
39672.91,831,783,48,63,254,19.5
39686.15,833,786,47,64,254,19.3
39698.48,832,783,49,63,254,19.5
39711.8,835,786,49,61,254,19.7
39724.28,831,783,48,63,254,19.5667
39736.64,832,783,49,63,253,19.6333
39749.71,835,792,43,63,255,19.5667
39762.2,831,782,49,63,254,19.4667
39774.89,835,786,49,63,255,19.3667
39787.74,836,786,50,62,255,19.5333
39799.98,833,783,50,64,254,19.6333
39813.3,834,785,49,64,255,19.6
39825.84,830,782,48,63,253,19.4667
39838.21,831,783,48,63,254,19.6667
39852.81,834,785,49,64,255,19.5333
39865.35,830,781,49,62,252,19.3667
39878.39,831,782,49,62,254,19.3667
39891.18,833,783,50,63,254,19.6333
39905.36,831,783,48,64,254,19.5667
39917.73,831,782,49,64,253,19.5667
39931.28,826,779,47,62,253,19.6333
39943.68,831,782,49,64,254,19.3
39956.01,830,783,47,64,254,19.5
39970.87,829,782,47,62,253,19.4667
39983.48,833,786,47,62,256,19.7
39995.81,825,781,44,63,254,19.4667
40007.87,828,785,43,62,255,19.5
40019.96,829,783,46,64,255,19.6333
40031.63,822,780,42,63,252,19.5
40044.03,827,785,42,62,255,19.4
40055.89,836,783,53,66,254,19.4333
40067.6,824,779,45,62,253,19.4
40079.8,828,784,44,64,254,19.4667
40091.64,824,783,41,63,251,19.4333
40103.64,824,784,40,64,254,19.6667
40115.8,827,784,43,63,253,19.6333
40127.52,820,780,40,61,252,19.6667
40139.46,826,782,44,63,254,19.4
40151.31,829,784,45,63,255,19.6
40163.05,821,782,39,63,253,19.4333
40175.75,829,785,44,64,255,19.7333
40187.68,828,783,45,64,254,19.3667
40199.32,825,774,51,63,253,19.5
40212.35,827,784,43,62,254,19.6
40224.15,824,782,42,63,252,19.9333
40236.26,830,785,45,64,254,19.7333
40248.1,829,783,46,63,254,19.5333
40259.78,823,779,44,63,253,19.5333
40272.14,829,790,39,64,254,19.6667
40283.99,827,783,44,63,255,19.5333
40295.72,823,780,43,63,253,19.6
40308.0,830,784,46,64,255,19.7333
40320.09,828,785,43,61,253,19.7667
40331.9,825,780,45,64,253,19.5333
40344.83,823,782,41,63,252,20.0
40356.89,823,779,44,63,253,19.9667
40368.86,829,784,45,63,254,19.8
40380.72,831,782,49,66,254,19.9667
40392.51,828,783,45,66,254,19.8333
40404.63,828,784,44,65,255,19.9333
40416.45,829,785,44,64,253,19.9
40428.19,828,782,46,65,253,20.1
40440.28,827,785,42,66,254,19.9333
40452.12,822,780,42,64,251,20.1
40463.97,829,783,46,65,254,20.1333
40476.0,827,781,46,65,254,20.1667
40487.72,823,780,43,66,253,20.0333
40499.68,826,785,41,65,255,20.2
40511.51,830,784,46,64,254,20.3333
40523.28,825,781,44,66,252,20.2333
40535.9,827,784,43,65,254,20.3667
40547.76,828,785,43,65,255,19.9667
40559.54,825,781,44,65,253,20.2
40572.28,827,783,44,66,254,20.4667
40584.03,824,780,44,65,253,20.4
40595.99,823,785,38,66,252,20.4333
40607.87,829,783,46,68,255,20.8333
40619.55,822,781,41,64,253,20.7667
40632.24,832,780,52,69,254,20.8
40644.1,828,783,45,67,254,20.9333
40655.86,825,779,46,67,253,21.0333
40668.95,828,787,41,69,254,21.2
40680.78,825,777,48,66,253,21.4
40693.2,828,780,48,68,253,21.2333
40707.48,832,784,48,69,255,21.3
40720.75,833,784,49,68,254,21.5333
40734.36,836,787,49,70,255,21.6667
40747.16,836,787,49,70,254,21.9
40759.96,832,784,48,70,254,22.3667
40773.08,833,785,48,71,255,22.2333
40786.1,834,786,48,71,255,21.8333
40799.06,833,781,52,71,254,22.2333
40813.02,832,784,48,69,254,22.2333
40825.33,830,781,49,71,253,21.9667
40838.08,832,784,48,71,254,22.0667
40850.37,829,781,48,70,253,22.2
40864.93,830,784,46,70,253,22.2333
40877.29,833,785,48,71,255,22.4667
40889.51,829,781,48,72,253,22.3667
40902.75,831,790,41,71,252,22.6667
40915.14,834,784,50,70,254,22.5
40930.66,832,782,50,70,253,22.4
40944.2,833,786,47,71,254,22.4
40956.77,831,782,49,72,254,22.4333
40970.21,834,784,50,71,255,22.3667
40982.71,833,785,48,72,254,22.7
40995.26,831,780,51,72,254,22.5667
41008.11,832,782,50,72,254,22.8667
41020.67,834,785,49,73,254,22.6
41033.44,829,779,50,72,252,22.9
41047.37,834,784,50,72,255,22.9667
41060.03,831,783,48,72,254,22.9667
41073.15,833,785,48,73,255,22.8667
41085.77,830,782,48,71,254,22.9
41098.29,825,777,48,72,253,22.8
41111.8,834,786,48,71,255,23.1333
41124.28,830,782,48,72,254,23.0333
41137.61,834,785,49,75,254,23.0667
41150.08,833,786,47,74,254,23.1333
41162.47,830,782,48,75,253,23.1333
41175.41,835,784,51,73,254,23.3
41187.93,831,781,50,72,253,23.6
41200.57,831,781,50,72,253,23.7667
41214.2,833,784,49,74,254,23.3667
41226.65,831,781,50,74,254,23.4
41239.86,835,786,49,73,255,23.2667
41252.37,835,783,52,73,253,23.5333
41265.75,833,785,48,74,254,23.4333
41278.38,835,786,49,74,255,23.6333
41290.88,831,782,49,74,253,23.3667
41303.52,833,785,48,74,254,23.3333
41315.97,831,790,41,75,254,23.6667
41328.32,832,784,48,74,255,23.5667
41341.07,834,786,48,76,255,23.4333
41353.57,831,783,48,72,254,23.6667
41365.96,834,784,50,76,255,23.7333
41378.64,834,784,50,74,255,23.9
41391.12,831,779,52,74,253,24.4333
41403.81,835,785,50,76,254,23.7333
41416.3,832,785,47,76,254,23.6333
41428.48,831,783,48,74,253,24.1333
41440.96,832,777,55,76,254,23.8333
41453.26,828,782,46,74,253,23.4667
41465.51,832,784,48,75,254,23.7
41478.21,836,785,51,76,255,24.0667
41490.53,829,781,48,76,253,24.2
41502.96,834,784,50,76,255,24.1
41515.3,833,784,49,78,254,24.4333
41527.8,834,785,49,76,254,24.2
41540.57,831,782,49,77,254,24.6667
41553.05,831,783,48,74,253,24.4333
41565.48,833,785,48,75,254,24.3333
41578.13,833,784,49,76,254,24.5333
41590.63,828,782,46,78,253,24.1
41603.26,831,791,40,74,254,24.5667
41615.81,831,785,46,77,254,24.3333
41628.04,832,784,48,76,254,24.9333
41640.58,832,784,48,76,254,24.5
41652.85,829,782,47,78,253,24.2667
41665.07,834,784,50,77,254,24.3667
41677.72,830,785,45,76,255,24.7
41690.04,829,782,47,78,253,24.8667
41702.53,833,784,49,77,254,24.9
41714.93,835,784,51,78,254,24.7
41727.59,834,784,50,79,254,25.1
41740.46,833,784,49,80,254,25.0333
41752.95,831,782,49,78,253,25.2667
41765.38,832,785,47,80,254,25.2667
41778.05,831,785,46,78,254,24.8667
41790.53,831,782,49,79,253,25.2667
41803.16,833,786,47,81,255,24.9333
41815.78,832,785,47,80,254,25.2667
41828.01,831,783,48,80,254,25.2333
41840.5,833,783,50,79,255,25.3333
41852.8,829,782,47,78,253,25.2333
41865.08,832,784,48,79,255,25.5333
41877.55,831,785,46,80,254,25.5
41890.04,831,781,50,79,253,25.6
41902.5,832,783,49,80,253,25.1333
41922.69,827,779,48,79,252,25.7
41938.21,830,782,48,80,253,25.7
41950.56,833,785,48,80,254,25.8667
41962.89,832,778,54,79,252,25.7333
41975.77,828,780,48,83,254,25.9667
41989.19,826,779,47,81,252,26.4
42002.41,827,780,47,80,254,25.8667
42015.24,822,777,45,79,252,26.6
42027.55,823,779,44,81,252,25.8
42039.78,827,783,44,82,254,25.7333
42051.65,823,778,45,82,252,25.9333
42065.63,824,779,45,83,252,26.1667
42078.03,828,783,45,82,254,26.2667
42089.81,824,779,45,81,253,25.8
42102.5,825,782,43,80,254,26.2
42114.38,828,783,45,82,254,26.4667
42126.12,823,783,40,81,251,26.3667
42139.12,828,784,44,83,255,26.2333
42150.97,826,777,49,83,253,26.4
42162.91,828,783,45,82,254,26.6
42174.83,828,784,44,83,254,26.4333
42186.58,824,778,46,84,253,26.7667
42198.91,828,783,45,84,254,26.7
42210.78,828,782,46,84,254,26.8
42222.54,823,779,44,83,252,26.6333
42234.78,827,790,37,84,254,26.5667
42246.66,828,781,47,84,252,26.6333
42258.48,824,780,44,84,252,26.5667
42270.86,829,785,44,84,253,26.8
42282.54,822,779,43,84,253,26.7333
42294.5,827,783,44,84,253,26.8667
42306.39,820,778,42,83,254,26.8667
42318.08,824,779,45,85,253,27.1
42330.73,826,783,43,83,254,27.0667
42342.6,828,782,46,84,251,26.8
42354.34,824,779,45,86,252,27.1333
42367.32,827,784,43,84,254,27.8667
42379.16,830,777,53,83,253,27.0333
42391.1,827,783,44,86,253,26.9667
42403.02,828,783,45,86,255,26.9
42415.08,822,778,44,85,253,27.1333
42427.44,827,784,43,87,254,27.0667
42439.29,826,782,44,85,254,27.1333
42451.03,823,779,44,84,253,27.2
42463.25,828,783,45,85,254,27.1333
42475.15,828,780,48,88,253,26.9
42486.97,823,780,43,86,252,27.4667
42499.19,829,782,47,86,254,27.5333
42510.94,823,778,45,86,252,26.6333
42522.91,826,787,39,88,254,27.1333
42534.82,828,783,45,85,254,27.1333
42546.55,824,780,44,87,252,27.5667
42559.22,827,784,43,86,254,27.4333
42571.1,828,783,45,85,255,27.2333
42582.77,824,778,46,85,253,27.6
42595.34,827,783,44,87,254,27.4
42607.21,823,778,45,86,253,27.8667
42619.09,828,784,44,87,254,27.4
42631.05,827,790,37,87,254,27.3
42642.78,823,779,44,86,253,27.0667
42654.78,828,783,45,88,254,27.6667
42666.63,822,783,39,85,254,27.2
42678.44,824,779,45,87,252,27.7333
42690.94,827,780,47,88,253,27.9
42702.81,829,783,46,88,254,28.1667
42714.6,825,778,47,88,253,28.1
42727.26,833,784,49,87,254,27.9333
42739.67,829,783,46,89,254,27.9333
42752.3,834,786,48,87,255,27.8
42766.14,832,782,50,87,255,27.8333
42784.91,830,781,49,88,253,27.6667
42798.45,834,784,50,89,254,28.1333
42811.24,831,783,48,89,254,28.3333
42824.82,829,780,49,87,253,27.7667
42838.24,826,777,49,89,253,28.1
42850.66,830,782,48,90,254,27.9
42862.98,829,787,42,88,253,27.7667
42875.34,827,779,48,89,252,28.0
42889.91,830,781,49,89,253,28.1
42902.81,833,782,51,91,254,27.9333
42915.69,829,781,48,90,253,28.1
42929.14,827,783,44,89,254,27.8
42941.0,823,779,44,91,252,27.7667
42953.44,832,784,48,88,254,28.2667
42965.32,827,783,44,90,254,27.3333
42977.07,823,780,43,86,252,28.2
42989.34,829,783,46,92,254,28.2333
43001.2,827,783,44,88,252,28.2333
43013.23,823,779,44,89,254,27.7333
43025.56,827,783,44,89,253,28.1
43037.3,822,779,43,92,253,28.1
43049.23,827,784,43,90,254,28.2333
43061.11,828,782,46,90,254,28.3667
43072.84,822,780,42,88,253,27.8333
43085.58,827,783,44,89,253,27.7667
43097.53,828,780,48,88,256,28.1667
43109.24,824,778,46,88,252,28.4667
43122.21,827,783,44,89,253,28.1
43134.04,831,778,53,89,250,28.6333
43145.99,828,783,45,90,254,28.4667
43157.87,827,779,48,89,253,28.6
43169.58,824,779,45,91,253,28.3667
43181.99,825,784,41,90,254,28.8333
43193.86,826,784,42,91,254,28.4333
43205.61,823,780,43,94,253,28.1667
43217.82,827,784,43,92,254,28.7667
43229.69,828,783,45,89,252,28.5
43241.5,828,775,53,90,252,28.7
43253.8,828,782,46,91,255,28.4667
43265.52,823,778,45,90,252,28.3333
43277.49,827,790,37,91,254,27.9667
43289.36,830,783,47,89,253,28.8333
43301.03,823,780,43,91,253,28.1
43313.71,827,780,47,91,255,28.2333
43325.62,828,783,45,88,254,28.4333
43337.37,824,779,45,91,252,28.2333
43350.34,829,784,45,89,255,28.6
43362.19,826,779,47,91,253,28.2333
43374.12,828,783,45,91,254,28.9333
43386.02,832,780,52,92,254,28.4667
43397.73,822,778,44,89,253,28.7667
43410.09,826,784,42,92,254,28.7
43421.96,828,778,50,89,254,28.2667
43433.68,823,779,44,89,253,28.5667
43445.89,827,783,44,91,254,28.4
43457.75,823,783,40,90,251,28.6333
43469.59,825,780,45,91,253,29.1333
43482.0,830,782,48,93,254,28.3667
43493.74,817,774,43,92,252,28.5667
43505.73,828,783,45,92,254,28.8667
43517.61,827,783,44,89,254,29.6
43529.33,824,778,46,91,253,28.6667
43542.02,826,784,42,92,254,28.8333
43553.9,829,784,45,91,254,29.0
43565.56,828,775,53,91,252,28.8667
43578.6,828,784,44,91,254,28.5667
43590.44,823,779,44,92,252,29.0667
43602.36,828,783,45,92,254,28.7667
43614.24,828,784,44,92,254,28.4667
43625.99,823,778,45,91,252,28.8667
43638.31,835,781,54,94,254,28.9333
43650.77,833,786,47,92,254,28.9667
43663.13,830,781,49,92,253,29.1333
43676.47,834,784,50,93,254,29.4
43689.06,830,783,47,94,253,29.1
43701.46,831,781,50,94,254,29.3667
43715.09,833,785,48,91,255,29.1667
43727.59,831,783,48,91,253,29.4
43740.34,832,785,47,93,254,29.5333
43752.84,835,785,50,93,255,28.5
43765.18,829,781,48,96,253,29.3333
43778.47,835,786,49,93,255,29.1
43790.97,831,781,50,94,254,29.9
43803.58,831,781,50,95,253,28.8333
43817.15,832,785,47,96,254,29.5
43829.54,828,782,46,94,253,29.0
43842.77,833,785,48,96,254,29.4667
43855.31,833,786,47,96,254,29.6667
43867.59,831,781,50,96,254,29.7667
43880.37,835,785,50,95,254,30.0
43892.85,830,782,48,96,253,29.7
43905.55,831,783,48,96,255,29.9
43918.6,834,785,49,96,254,29.5333
43930.94,830,782,48,96,254,29.4333
43944.28,835,779,56,96,254,29.8333
43956.77,829,782,47,96,253,29.7333
43969.13,830,781,49,93,253,29.8333
43982.19,834,785,49,97,254,29.5667
43994.7,829,782,47,94,253,29.5667
44007.41,831,784,47,97,254,29.4667
44020.19,835,786,49,97,255,29.6
44032.43,836,783,53,97,253,29.7333
44045.91,833,784,49,97,254,30.0333
44058.4,830,782,48,98,253,29.6
44070.86,832,782,50,94,253,29.3333
44084.43,833,785,48,97,254,29.9
44096.92,831,781,50,96,254,30.0333
44109.65,835,785,50,96,254,29.9
44122.15,835,785,50,95,255,30.0667
44134.43,831,782,49,98,253,30.0
44147.49,834,785,49,95,254,30.1667
44159.99,832,784,48,97,254,29.5
44172.6,834,782,52,96,253,29.4667
44186.18,834,785,49,98,255,30.0667
44198.61,832,782,50,95,254,29.6667
44211.78,835,784,51,95,255,29.6333
44224.27,833,786,47,97,255,29.5333
44236.68,831,783,48,96,254,29.5667
44249.44,836,781,55,97,255,29.7333
44261.93,831,783,48,98,254,29.3667
44274.58,830,784,46,98,255,29.9667
44287.74,835,787,48,95,254,29.9333
44300.04,832,783,49,97,254,29.7667
44313.39,835,784,51,96,255,29.4667
44325.94,832,783,49,95,254,29.8333
44338.36,832,783,49,96,254,29.3
44351.45,835,786,49,97,255,29.9333
44363.96,831,783,48,95,254,29.6
44376.6,835,787,48,97,254,29.2
44389.09,835,785,50,97,255,29.6667
44401.38,829,783,46,96,253,30.0
44414.62,835,786,49,97,255,29.4667
44427.13,831,783,48,95,254,29.6667
44439.66,831,781,50,97,254,29.7
44453.48,836,787,49,96,255,29.6333
44466.05,832,783,49,95,252,29.8
44478.77,835,783,52,96,255,29.8
44491.26,834,787,47,98,254,30.0667
44503.58,832,783,49,96,254,29.3667
44516.58,835,786,49,97,255,30.5
44529.07,832,783,49,96,254,30.0667
44541.73,830,781,49,96,254,30.3667
44555.35,836,784,52,102,253,30.4333
44567.73,831,783,48,99,254,30.0667
44580.98,835,787,48,97,255,30.3667
44593.48,835,786,49,99,255,30.3333
44605.87,833,783,50,97,254,30.4
44618.74,835,785,50,101,255,30.8333
44631.25,831,783,48,98,253,30.6
44643.99,831,787,44,103,254,30.9333
44657.43,831,784,47,104,255,30.9
44669.81,832,783,49,101,254,30.8667
44683.04,836,785,51,99,255,30.8667
44695.59,831,783,48,103,254,31.4667
44708.01,829,781,48,101,255,31.3
44721.18,835,786,49,103,255,31.4
44733.65,831,782,49,101,254,30.9333
44746.26,834,785,49,102,255,31.0
44758.77,834,786,48,106,255,32.0333
44771.2,838,790,48,103,254,32.1
44784.39,835,785,50,103,255,31.2667
44796.89,831,783,48,105,253,31.7333
44809.33,831,782,49,104,254,31.6
44822.87,835,786,49,105,255,31.5333
44835.4,833,783,50,105,253,31.6333
44848.12,837,786,51,107,255,31.7333
44860.62,835,786,49,107,256,32.0
44873.02,832,781,51,104,253,30.9667
44886.25,834,785,49,107,255,32.3667
44898.71,839,783,56,106,255,31.7667
44911.22,830,781,49,105,253,31.9667
44924.86,836,785,51,104,254,31.6667
44937.28,832,782,50,106,254,32.0
44950.31,833,785,48,107,255,32.0667
44962.81,836,784,52,106,255,32.0667
44975.29,831,783,48,107,254,32.6667
44988.13,832,786,46,110,253,32.6667
45000.61,833,783,50,106,254,32.4333
45013.32,832,782,50,109,254,32.2667
45026.4,834,786,48,109,255,32.4
45038.76,834,783,51,109,254,32.2333
45052.12,833,786,47,107,255,32.2667
45064.6,829,784,45,108,254,32.6333
45076.98,831,779,52,107,254,32.7667
45089.97,834,786,48,110,255,32.3333
45102.49,832,783,49,110,254,32.4667
45115.16,835,786,49,109,256,32.7333
45128.0,833,786,47,108,255,32.4
45140.31,832,780,52,107,253,32.8667
45153.93,834,786,48,108,255,32.4667
45166.48,832,783,49,110,254,32.3333
45178.92,831,782,49,109,253,32.9
45192.01,835,786,49,109,255,32.7667
45204.53,832,782,50,106,252,32.7
45217.15,835,785,50,108,254,32.6333
45229.76,834,785,49,109,254,32.3333
45242.14,832,783,49,107,254,33.0667
45255.5,834,785,49,112,255,32.6
45267.98,830,783,47,110,253,32.6
45280.42,832,782,50,107,253,33.3333
45293.9,834,783,51,107,255,32.4667
45306.41,833,782,51,109,253,32.3
45319.23,835,786,49,109,255,32.5333
45331.7,832,786,46,109,254,32.9333
45344.1,831,782,49,108,253,32.7333
45357.19,834,785,49,109,255,32.9
45369.69,831,783,48,106,254,32.3333
45382.17,834,781,53,112,255,33.0
45395.76,835,786,49,108,254,32.8
45408.19,830,782,48,108,253,32.2667
45421.39,836,785,51,109,255,32.6333
45433.87,835,786,49,110,255,33.2
45446.27,831,782,49,107,253,32.8
45459.13,834,785,49,109,255,32.2333
45471.63,833,782,51,108,254,33.2667
45484.31,831,782,49,107,254,33.4667
45497.33,834,785,49,109,255,32.2667
45509.68,834,783,51,110,253,32.7333
45523.02,834,786,48,108,255,32.5
45535.67,831,783,48,108,254,32.7667
45548.11,834,782,52,108,254,32.6333
45561.03,834,786,48,108,255,31.8667
45573.52,831,783,48,109,253,32.4667
45586.23,834,786,48,110,255,33.1
45599.05,834,785,49,108,255,32.4667
45611.36,832,782,50,109,254,32.9333
45624.78,832,786,46,109,255,31.8
45637.29,831,783,48,111,254,32.6333
45649.69,831,781,50,108,253,32.5333
45662.85,833,786,47,107,254,32.6333
45675.98,831,783,48,109,254,32.6333
45688.69,836,791,45,110,255,32.1667
45701.21,832,783,49,107,254,32.1
45713.99,830,780,50,108,253,32.2667
45727.8,832,783,49,108,254,32.3
45741.13,829,780,49,106,253,32.0
45754.27,824,779,45,104,252,31.8
45767.03,825,780,45,104,253,31.8333
45779.03,826,775,51,103,253,31.1667
45791.54,828,783,45,103,254,31.3333
45803.64,829,782,47,103,253,31.9
45815.44,824,775,49,100,251,31.1667
45830.63,821,781,40,103,254,31.8
45843.24,825,779,46,99,253,32.0667
45855.67,826,785,41,102,254,31.1333
45867.5,829,783,46,102,255,31.0
45879.34,825,779,46,98,252,30.8
45892.08,825,785,40,100,254,30.7333
45904.0,824,780,44,98,253,30.9
45915.91,827,785,42,104,255,30.7333
45927.78,830,784,46,101,254,30.3
45939.49,824,778,46,99,253,30.5
45952.66,829,784,45,98,254,30.5
45964.52,829,783,46,98,254,29.6667
45976.21,824,779,45,99,253,30.1667
45989.18,828,783,45,97,254,29.9333
46000.98,826,780,46,94,253,29.9
46012.91,827,785,42,95,254,29.7333
46024.74,829,783,46,96,254,29.6667
46036.66,824,779,45,93,252,29.5
46048.93,827,785,42,92,254,29.7
46060.78,827,784,43,92,254,29.0333
46072.56,823,780,43,93,253,29.6333
46084.78,829,784,45,92,254,29.1667
46096.63,829,783,46,91,253,29.1667
46108.44,829,784,45,93,254,28.7667
46121.12,828,784,44,93,255,29.4333
46132.76,825,780,45,93,253,28.8
46144.81,827,785,42,90,254,28.7667
46156.66,827,782,45,92,254,28.5333
46168.39,828,783,45,92,254,28.3667
46180.42,828,784,44,92,254,28.6333
46192.26,829,782,47,92,254,28.4
46204.01,828,783,45,91,254,28.1667
46216.18,829,784,45,91,254,28.6333
46228.04,824,780,44,90,253,28.3
46240.0,826,782,44,92,254,28.2667
46251.84,828,784,44,91,254,28.4
46263.54,829,783,46,89,254,27.9
46275.68,829,784,45,88,254,27.6333
