time_ms,temp_0,temp_1,temp_0_1,diff_p,abs_p,sfm3300
1.14,831,787,44,43,255,0.0
29.51,831,783,48,41,254,0.0
42.48,835,786,49,42,254,0.0
54.74,833,787,46,42,255,0.0
66.85,836,787,49,42,255,0.0
79.74,833,787,46,42,254,0.0
92.02,830,779,51,42,255,0.0
105.48,836,787,49,42,256,0.0
117.98,832,784,48,42,254,0.0
132.2,835,786,49,43,255,0.0
145.28,833,783,50,42,253,0.0
158.32,832,784,48,42,254,0.0
171.7,836,786,50,43,254,0.0
183.98,840,784,56,42,255,0.0
196.33,834,787,47,42,254,0.0
208.59,836,787,49,41,255,0.0
220.65,830,783,47,42,254,0.0
233.92,835,787,48,42,254,0.0
246.16,831,782,49,42,254,0.0
258.62,835,786,49,43,255,0.0
270.97,837,788,49,42,255,0.0
283.6,834,784,50,42,254,0.0
296.77,837,787,50,42,255,0.0
309.51,832,785,47,42,256,0.0
322.38,833,783,50,42,254,0.0
336.11,835,787,48,42,255,0.0
348.9,833,785,48,42,255,0.0
362.33,831,792,39,42,255,0.0
375.02,832,783,49,42,254,0.0
388.17,836,786,50,42,255,0.0
400.72,833,784,49,43,255,0.0
413.19,835,783,52,41,254,0.0
426.73,836,786,50,41,254,0.0
439.23,831,784,47,42,254,0.0
453.18,837,788,49,43,255,-0.0333
465.66,832,784,48,42,254,0.0
478.26,837,787,50,42,255,0.0
491.14,836,787,49,42,255,0.0
503.37,832,783,49,42,254,0.0
516.52,835,787,48,42,255,0.0
529.0,832,784,48,42,254,0.0
541.77,836,786,50,42,255,0.0
554.2,831,784,47,42,253,0.0
566.59,833,783,50,42,253,0.0
579.63,837,783,54,42,256,0.0
592.11,832,782,50,43,253,0.0
605.34,832,784,48,42,253,0.0
618.28,833,784,49,42,254,0.0
630.85,833,784,49,43,254,0.0
644.29,834,787,47,42,255,0.0
656.75,832,784,48,42,254,0.0
670.45,835,787,48,42,255,0.0
682.91,834,785,49,43,253,0.0
695.4,836,787,49,42,255,0.0
708.16,833,787,46,42,255,0.0
720.5,832,784,48,42,254,0.0
733.78,837,788,49,43,256,0.0
746.2,832,784,48,42,254,0.0
758.83,831,788,43,41,254,0.0
771.32,836,786,50,43,255,0.0
783.68,833,784,49,42,254,0.0
796.47,836,788,48,42,255,0.0
809.03,834,784,50,42,254,0.0
821.9,834,787,47,42,255,0.0
834.67,832,785,47,42,253,0.0
847.2,832,784,48,42,255,0.0
860.65,836,787,49,42,255,0.0
873.11,834,784,50,42,254,0.0
886.43,837,787,50,41,255,0.0
898.97,833,783,50,42,254,0.0
911.59,832,783,49,42,254,-0.0333
924.73,834,788,46,42,255,0.0
937.05,832,783,49,41,255,0.0
950.35,836,789,47,43,255,0.0
962.86,833,783,50,41,254,0.0
975.61,831,787,44,42,255,0.0
988.08,835,788,47,41,255,0.0
1000.51,832,784,48,43,254,0.0
1013.31,837,787,50,42,255,0.0
1025.76,829,782,47,42,253,0.0
1038.56,836,788,48,42,255,0.0
1050.99,834,785,49,42,254,0.0
1063.35,834,783,51,42,254,0.0
1076.32,833,787,46,42,255,0.0
1088.84,834,782,52,42,254,0.0
1101.97,835,787,48,42,255,0.0
1114.39,832,784,48,42,254,0.0
1126.87,830,783,47,42,254,0.0
1140.48,837,786,51,42,255,0.0
1152.95,833,784,49,42,254,0.0
1168.46,835,787,48,43,254,0.0
1180.92,831,784,47,43,255,0.0
1193.58,836,786,50,42,255,0.0
1206.13,834,783,51,42,254,0.0
1219.24,832,784,48,42,254,0.0
1232.56,835,787,48,43,255,0.0
1245.02,829,784,45,42,252,0.0
1257.91,835,787,48,42,255,0.0
1270.36,833,785,48,42,253,0.0
1282.92,832,783,49,42,254,0.0
1296.3,836,786,50,41,255,0.0
1308.86,833,784,49,42,254,0.0
1322.5,833,787,46,43,255,0.0
1335.25,833,780,53,41,255,0.0
1347.88,831,783,48,43,255,0.0
1361.1,836,786,50,42,255,0.0
1373.57,832,783,49,42,253,-0.0333
1387.06,836,784,52,42,254,0.0
1399.63,832,784,48,42,254,0.0
1412.24,835,787,48,41,255,0.0
1424.83,836,784,52,42,256,0.0
1437.17,833,784,49,42,254,0.0
1450.25,836,787,49,42,255,0.0
1462.74,831,784,47,41,254,0.0
1475.4,835,787,48,41,255,0.0
1488.15,834,787,47,42,254,0.0
1501.1,833,784,49,43,254,0.0
1514.42,840,788,52,43,253,0.0
1526.92,832,783,49,43,253,0.0
1540.53,835,787,48,43,254,0.0
1552.97,833,784,49,42,254,0.0
1565.65,832,784,48,43,254,0.0
1579.21,835,786,49,41,254,0.0
1591.77,832,784,48,42,254,0.0
1605.62,831,791,40,42,254,0.0
1618.16,833,784,49,42,254,0.0
1630.92,836,786,50,42,255,0.0
1643.56,835,787,48,43,254,0.0
1656.31,832,784,48,42,254,0.0
1669.24,835,788,47,42,254,0.0
1681.84,831,785,46,42,254,0.0
1695.04,835,792,43,43,256,0.0
1707.55,834,784,50,41,254,0.0
1720.13,833,783,50,41,254,0.0
1733.71,837,787,50,42,255,0.0
1746.23,832,783,49,43,254,0.0
1759.88,835,787,48,42,255,0.0
1772.71,833,784,49,44,255,0.0
1785.35,827,784,43,42,254,0.0
1798.49,837,786,51,42,255,0.0
1810.92,832,783,49,43,254,0.0
1824.24,836,787,49,41,255,0.0
1837.15,835,787,48,41,255,0.0
1850.03,834,788,46,42,255,0.0
1863.07,837,786,51,43,255,0.0
1875.63,832,784,48,42,254,0.0
1889.08,838,786,52,43,255,0.0
1901.65,836,787,49,43,255,0.0
1914.33,836,786,50,43,256,0.0
1927.25,833,784,49,41,254,0.0
1939.98,831,783,48,42,254,0.0
1952.76,835,786,49,43,255,0.0
1965.33,832,784,48,40,253,0.0
1978.78,835,788,47,43,254,0.0
1991.25,831,783,48,43,253,0.0
2003.71,831,783,48,42,254,0.0
2017.24,836,786,50,41,255,0.0
2029.62,831,783,48,42,254,0.0
2043.01,834,785,49,42,254,0.0
2055.66,826,784,42,43,255,0.0
2068.19,835,786,49,41,255,0.0
2080.58,836,786,50,42,255,0.0
2092.79,832,783,49,42,254,0.0
2106.52,835,787,48,42,255,0.0
2119.08,834,784,50,42,254,0.0
2131.86,835,788,47,42,255,0.0
2144.44,835,788,47,42,256,0.0
2157.15,832,784,48,41,254,0.0
2170.12,831,782,49,43,251,0.0
2183.51,832,784,48,42,253,0.0
2196.59,835,786,49,42,255,0.0
2209.21,831,784,47,42,254,0.0
2221.78,831,784,47,42,254,0.0
2235.41,835,788,47,42,255,0.0
2247.92,831,783,48,41,254,-0.0333
2261.68,834,787,47,43,255,0.0
2274.41,832,783,49,42,254,0.0
2286.95,832,787,45,43,255,0.0
2301.8,832,783,49,42,254,0.0
2314.38,830,784,46,42,254,0.0
2327.48,835,787,48,42,255,0.0
2340.04,831,781,50,42,253,0.0
2352.96,834,787,47,42,254,0.0
2365.4,832,784,48,41,254,0.0
2377.89,832,783,49,42,255,0.0
2391.53,835,786,49,42,255,0.0
2403.98,832,783,49,42,253,0.0
2417.29,831,783,48,42,253,0.0
2431.34,831,783,48,43,253,0.0
2443.92,833,783,50,42,255,0.0
2456.85,836,787,49,43,255,0.0
2469.2,831,779,52,42,254,-0.0333
2482.15,836,786,50,42,255,0.0
2494.59,831,784,47,42,254,0.0
2507.29,835,786,49,41,255,0.0
2519.9,834,786,48,42,255,0.0
2532.28,832,783,49,42,253,0.0
2545.29,836,785,51,42,255,0.0
2557.73,833,781,52,42,254,0.0
2570.47,834,787,47,42,255,0.0
2582.9,832,784,48,42,254,0.0
2595.23,829,783,46,41,254,0.0
2608.13,835,785,50,42,255,0.0
2620.66,831,783,48,41,253,0.0
2633.75,836,786,50,42,255,0.0333
2646.16,833,784,49,42,253,0.0
2658.65,832,781,51,43,253,0.0
2672.44,836,785,51,43,254,0.0
2685.02,831,781,50,42,253,0.0
2698.47,835,787,48,42,255,0.0
2710.93,831,783,48,42,253,0.0
2723.47,836,787,49,41,255,0.0
2736.23,835,787,48,42,255,0.0
2748.58,829,782,47,42,254,0.0
2762.05,834,787,47,42,255,0.0
2774.5,833,783,50,42,255,0.0
2787.14,836,787,49,42,255,0.0
2799.76,835,785,50,42,255,0.0
2812.15,831,783,48,42,254,0.0
2825.15,835,785,50,43,255,0.0
2837.61,832,781,51,42,254,0.0
2850.31,835,786,49,43,255,0.0
2862.73,829,781,48,42,253,-0.0333
2875.58,831,783,48,42,254,0.0
2888.43,831,787,44,42,255,0.0
2900.92,829,782,47,42,254,0.0
2913.81,833,787,46,42,255,-0.0333
2926.23,831,784,47,42,254,0.0
2938.79,831,783,48,41,254,0.0
2952.28,835,786,49,42,255,0.0
2964.74,833,784,49,43,254,0.0
2977.99,834,785,49,42,255,0.0
2990.52,832,783,49,41,252,0.0
3003.17,831,782,49,42,254,0.0
3016.38,835,787,48,41,255,-0.0333
3029.06,832,782,50,43,254,0.0
3042.58,835,784,51,42,254,0.0
3055.1,833,784,49,43,254,0.0
3067.74,836,785,51,41,255,0.0
3080.24,835,782,53,43,255,0.0
3092.61,829,781,48,43,254,0.0
3105.63,834,784,50,41,255,0.0
3117.9,831,782,49,42,254,0.0
3130.29,832,786,46,42,255,0.0
3142.51,835,787,48,42,255,0.0
3154.56,830,782,48,41,253,0.0
3167.34,835,785,50,42,255,0.0
3179.64,832,783,49,42,253,0.0
3192.09,834,787,47,42,255,0.0
3204.43,833,786,47,42,255,0.0
3216.82,831,783,48,41,254,0.0
3229.89,836,786,50,43,255,0.0
3242.33,840,783,57,42,254,0.0
3255.14,837,785,52,44,255,0.0
3267.56,831,784,47,42,253,0.0
3279.97,829,783,46,42,254,0.0
3292.73,836,785,51,41,255,0.0
3305.27,831,783,48,42,253,0.0
3317.93,835,787,48,42,254,0.0
3330.34,833,783,50,42,253,0.0
3342.71,829,782,47,42,253,0.0
3355.78,835,786,49,41,254,0.0
3368.25,832,777,55,42,253,0.0
3381.33,836,786,50,41,255,0.0
3393.75,831,783,48,41,254,0.0
3406.63,831,783,48,42,254,0.0
3419.76,836,785,51,41,254,0.0
3432.2,831,783,48,42,254,0.0333
3445.49,836,785,51,42,254,0.0
3457.94,833,780,53,42,254,0.0
3470.66,831,782,49,42,253,0.0
3483.82,835,786,49,43,255,-0.0333
3496.21,834,783,51,43,254,0.0
3509.77,836,784,52,42,254,0.0
3522.23,833,783,50,42,253,-0.0333
3534.88,834,787,47,41,254,0.0
3547.45,831,784,47,42,254,0.0
3560.28,832,783,49,42,254,0.0
3573.49,836,785,51,42,255,0.0
3585.95,833,781,52,42,254,0.0
3598.74,834,787,47,41,255,0.0
3611.22,826,777,49,42,252,0.0
3624.43,831,783,48,41,254,0.0
3637.81,835,785,50,41,255,0.0
3650.34,832,783,49,42,254,0.0
3663.58,835,787,48,41,256,0.0
3676.1,831,784,47,43,255,0.0
3688.8,833,783,50,42,254,0.0
3702.55,836,784,52,42,254,0.0
3715.18,832,783,49,41,254,0.0
3728.25,832,785,47,42,254,0.0
3740.78,834,785,49,42,254,0.0
3753.5,835,786,49,43,254,0.0
3766.3,835,786,49,41,254,0.0
3778.81,831,783,48,41,254,0.0
3791.79,834,786,48,42,254,0.0
3804.33,835,787,48,43,255,0.0
3817.03,835,788,47,42,254,0.0
3829.91,833,786,47,42,255,0.0
3842.39,831,780,51,42,253,0.0
3855.37,836,786,50,41,255,0.0
3867.91,834,786,48,42,254,0.0
3880.61,835,786,49,42,255,0.0
3893.48,831,782,49,41,254,0.0
3905.91,832,783,49,41,254,0.0
3918.76,836,785,51,42,255,-0.0333
3931.23,833,784,49,42,254,0.0
3943.87,836,782,54,43,254,0.0
3956.36,832,784,48,42,254,0.0
3968.81,831,783,48,42,254,0.0
3981.53,834,786,48,44,255,0.0
3994.01,832,784,48,41,253,0.0
4006.73,836,785,51,42,255,0.0
4019.33,831,784,47,42,254,0.0
4031.77,831,783,48,42,253,0.0
4044.51,836,784,52,42,255,0.0
4057.02,832,781,51,43,254,0.0
4069.86,834,785,49,42,255,0.0
4082.29,831,783,48,41,254,0.0
4094.68,831,784,47,42,254,0.0
4107.6,835,787,48,42,255,0.0
4120.08,831,783,48,42,253,0.0
4133.11,836,787,49,41,255,0.0
4145.54,832,782,50,43,254,0.0
4158.05,831,783,48,43,253,0.0
4171.63,836,786,50,42,255,0.0
4184.11,832,783,49,41,254,0.0
4197.45,833,785,48,42,255,0.0
4209.95,831,783,48,41,254,0.0
4222.54,832,782,50,42,254,0.0
4235.4,835,787,48,42,255,0.0
4248.28,832,783,49,43,254,0.0
4261.66,835,786,49,43,255,0.0
4274.14,832,783,49,43,255,0.0
4286.79,837,784,53,41,254,0.0
4299.39,834,785,49,43,254,0.0
4311.8,831,783,48,43,254,0.0
4324.7,834,785,49,43,255,0.0
4336.97,831,783,48,41,254,0.0
4349.49,834,786,48,41,255,0.0
4361.74,833,787,46,43,255,0.0
4373.85,830,782,48,42,253,0.0
4386.6,834,784,50,41,255,0.0
4398.89,831,783,48,42,254,0.0
4411.34,835,785,50,42,255,0.0
4423.68,834,786,48,41,255,0.0
4436.02,831,782,49,42,253,0.0
4449.03,832,787,45,43,256,0.0
4461.49,833,782,51,44,254,0.0
4474.21,837,787,50,43,256,0.0
4486.65,833,784,49,43,254,0.0
4499.05,832,783,49,42,254,0.0
4511.89,834,787,47,42,255,-0.0333
4524.42,832,783,49,42,254,0.0
4537.61,835,788,47,42,254,0.0
4550.07,832,783,49,41,254,0.0
4562.56,834,784,50,41,254,0.0
4576.13,840,787,53,43,256,0.0
4588.59,832,785,47,43,254,0.0
4602.24,837,785,52,42,255,0.0
4614.7,834,784,50,42,254,0.0
4627.25,837,786,51,42,256,0.0
4640.08,836,786,50,43,255,0.0
4652.38,833,784,49,42,254,0.0
4665.72,837,779,58,42,256,0.0333
4678.19,833,784,49,43,254,0.0
4690.95,834,786,48,43,255,0.0
4703.51,836,786,50,43,255,0.0333
4715.96,832,784,48,42,254,0.0
4729.01,836,787,49,43,255,0.0
4741.53,833,784,49,41,254,0.0
4754.4,835,792,43,42,255,0.0
4766.91,833,784,49,42,254,0.0
4779.33,833,784,49,42,254,0.0
4792.32,836,786,50,43,255,0.0
4804.86,834,783,51,42,254,0.0
4817.94,836,786,50,42,254,0.0
4830.59,834,784,50,42,254,0.0
4843.21,831,784,47,42,254,0.0
4856.87,835,788,47,42,254,0.0
4869.36,833,784,49,42,254,0.0
4882.75,837,788,49,41,255,-0.0333
4895.29,831,784,47,42,254,0.0
4908.0,835,787,48,42,256,0.0
4920.57,836,787,49,42,254,0.0
4933.0,831,781,50,41,253,0.0
4946.52,834,787,47,41,255,0.0
4959.2,830,784,46,42,254,0.0
4972.22,836,787,49,42,255,0.0
4984.73,834,784,50,42,254,0.0
4997.16,833,784,49,42,254,0.0
5010.31,834,784,50,42,254,0.0
5022.85,832,783,49,43,254,0.0
5036.19,837,787,50,42,255,0.0
5048.72,833,784,49,42,254,0.0
5061.31,833,783,50,42,254,0.0
5074.87,836,787,49,41,255,0.0
5087.37,830,785,45,42,254,0.0
5101.18,836,786,50,44,255,0.0
5113.68,833,784,49,42,254,0.0
5126.28,832,786,46,42,254,0.0
5139.75,837,786,51,42,255,0.0
5152.18,833,784,49,42,254,0.0
5165.04,835,788,47,42,255,0.0
5177.49,833,782,51,43,254,0.0
5190.23,836,787,49,43,255,0.0
5202.65,831,784,47,42,254,0.0
5215.06,834,783,51,42,254,0.0
5227.95,835,787,48,43,255,0.0
5240.52,834,784,50,42,253,0.0
5253.63,837,786,51,43,254,0.0
5266.07,833,784,49,41,254,0.0
5278.53,831,783,48,42,254,0.0
5291.94,836,787,49,42,255,0.0
5304.38,833,784,49,42,254,0.0
5317.67,837,788,49,42,255,0.0
5330.14,833,777,56,42,254,0.0
5342.76,831,783,48,43,254,-0.0333
5356.01,835,788,47,41,255,0.0
5368.39,832,783,49,43,254,0.0
5381.67,835,786,49,42,254,-0.0333
5394.13,833,784,49,42,254,0.0
5406.79,835,785,50,42,255,0.0
5419.37,835,787,48,42,255,0.0
5431.89,833,783,50,42,254,0.0
5444.73,836,787,49,41,255,0.0
5457.2,834,784,50,42,254,0.0
5470.02,837,787,50,42,255,0.0
5482.43,833,784,49,43,254,0.0
5494.79,832,784,48,42,254,0.0
5507.59,837,786,51,42,255,0.0
5520.07,834,783,51,41,254,0.0
5532.84,837,787,50,41,255,0.0
5545.27,833,784,49,42,254,0.0
5557.63,833,784,49,43,254,0.0
5570.5,836,786,50,43,255,0.0
5582.98,832,785,47,42,254,0.0
5596.11,835,787,48,42,255,0.0
5608.55,832,783,49,42,254,0.0
5621.12,835,784,51,43,254,0.0
5635.46,836,787,49,43,254,0.0
5647.99,834,784,50,42,253,0.0
5661.56,836,786,50,43,255,0.0
5674.02,833,784,49,42,254,0.0
5686.53,837,787,50,42,255,0.0
5699.35,836,787,49,42,255,0.0
5711.66,835,783,52,42,254,0.0
5725.15,836,786,50,42,255,0.0
5737.66,833,784,49,43,254,0.0
5750.3,837,788,49,41,255,0.0
5762.79,835,791,44,42,255,0.0
5775.13,832,784,48,43,254,0.0
5788.13,835,788,47,43,255,0.0
5800.63,831,785,46,42,254,0.0
5813.3,838,787,51,42,255,0.0
5825.72,833,783,50,42,254,0.0
5838.09,832,784,48,41,254,0.0
5851.07,836,787,49,41,255,0.0
5863.56,832,784,48,42,253,0.0
5876.59,836,787,49,42,254,0.0
5889.1,840,784,56,42,253,0.0
5901.57,832,783,49,41,254,0.0
5914.86,837,787,50,41,255,0.0
5927.32,833,783,50,42,253,0.0
5940.61,836,787,49,42,254,0.0
5953.08,833,784,49,42,254,0.0
5965.71,833,783,50,41,253,0.0
5978.92,843,783,60,43,255,0.0
5991.31,832,784,48,43,254,0.0
6004.94,837,787,50,42,255,0.0
6017.41,833,784,49,42,254,0.0
6030.05,838,787,51,42,255,0.0
6042.57,835,785,50,42,255,0.0
6054.83,836,786,50,42,255,0.0
6067.76,835,787,48,42,255,0.0
6080.22,831,784,47,42,254,0.0
6092.87,835,788,47,43,255,-0.0333
6105.41,834,788,46,42,254,0.0
6117.72,835,786,49,42,255,0.0
6130.6,836,786,50,42,255,0.0
6143.24,832,781,51,42,253,0.0
6155.88,835,786,49,42,255,0.0
6168.12,834,787,47,42,255,0.0
6180.31,831,783,48,43,253,0.0
6192.94,832,786,46,42,254,0.0
6205.53,831,783,48,42,254,0.0
6217.97,836,785,51,42,254,0.0
6230.22,835,782,53,41,254,0.0
6242.38,831,783,48,42,254,0.0
6256.3,837,786,51,42,255,0.0
6268.85,833,785,48,42,254,0.0
6283.0,835,787,48,43,255,0.0
6298.82,831,784,47,42,254,0.0
6311.87,835,786,49,43,254,0.0
6324.68,833,784,49,42,254,0.0
6337.35,836,787,49,43,255,0.0
6350.09,835,787,48,42,255,0.0
6362.38,835,787,48,43,254,0.0
6375.0,835,791,44,41,253,0.0
6387.28,831,784,47,43,254,0.0
6399.66,835,786,49,42,255,0.0
6412.35,837,786,51,42,255,0.0
6424.69,834,786,48,42,255,0.0
6437.32,836,785,51,42,254,0.0
6449.67,834,784,50,42,254,-0.0333
6462.28,834,787,47,43,255,0.0
6474.92,836,786,50,42,255,0.0
6487.46,836,787,49,41,255,0.0
6500.26,837,787,50,42,255,0.0
6512.75,835,784,51,42,253,0.0
6525.37,836,786,50,43,255,0.0
6538.41,837,787,50,42,255,0.0
6550.98,834,786,48,42,254,0.0
6563.56,834,787,47,42,255,0.0
6575.87,831,783,48,42,253,0.0
6588.39,835,786,49,42,254,0.0
6600.92,835,788,47,42,254,0.0
6613.15,835,787,48,42,255,0.0
6625.7,835,786,49,42,254,0.0
6638.03,832,783,49,42,254,0.0
6650.47,834,786,48,42,255,0.0
6662.94,835,785,50,43,256,0.0
6675.26,833,785,48,42,255,0.0
6687.85,834,784,50,42,255,0.0
6700.17,827,784,43,43,254,0.0
6712.51,835,786,49,42,255,-0.0333
6725.09,835,786,49,42,254,0.0
6737.4,833,784,49,42,254,0.0
6751.82,835,786,49,42,254,0.0
6764.09,832,783,49,42,254,0.0
6776.52,835,783,52,42,254,0.0
6788.88,835,787,48,42,256,0.0
6801.03,831,783,48,42,254,0.0
6813.65,834,786,48,42,254,0.0
6825.97,831,783,48,40,253,0.0
6838.48,834,786,48,42,255,0.0
6850.87,835,788,47,42,255,0.0
6863.28,833,784,49,42,254,0.0
6876.3,836,783,53,42,253,0.0
6888.87,831,784,47,42,254,0.0
6901.73,836,786,50,43,255,0.0
6914.19,832,785,47,42,254,0.0
6926.62,831,781,50,41,254,0.0
6939.82,837,787,50,42,256,0.0
6952.34,832,783,49,42,254,0.0
6965.64,835,788,47,42,255,0.0
6978.14,830,781,49,42,253,0.0
6990.99,832,784,48,41,254,0.0
7004.17,837,786,51,43,255,0.0
7016.77,833,784,49,42,254,0.0
7030.38,836,788,48,42,255,0.0
7042.9,832,784,48,41,254,0.0
7055.49,836,787,49,42,255,0.0
7068.3,836,787,49,43,255,0.0
7080.73,833,784,49,43,254,0.0
7093.76,832,784,48,43,254,0.0
7106.31,833,784,49,41,254,0.0
7119.27,834,787,47,42,256,0.0
7131.77,834,785,49,42,254,0.0
7144.18,832,784,48,43,254,-0.0333
7157.35,834,787,47,41,255,0.0
7169.91,833,784,49,43,254,0.0
7183.18,835,787,48,42,255,0.0
7195.66,833,784,49,42,254,0.0
7208.25,832,784,48,42,254,0.0
7221.83,832,785,47,42,253,-0.0333
7234.35,832,785,47,42,254,0.0
7248.03,835,786,49,43,255,0.0
7260.6,832,784,48,43,253,0.0
7273.21,835,788,47,42,255,0.0
7286.04,836,786,50,42,255,0.0
7298.47,833,784,49,42,254,0.0
7311.49,837,787,50,41,255,-0.0333
7324.01,833,782,51,42,254,0.0
7336.85,837,786,51,42,255,0.0
7349.37,834,784,50,41,254,0.0
7361.79,831,783,48,42,254,0.0
7374.64,835,787,48,41,255,0.0
7387.18,832,783,49,42,254,0.0
7400.48,836,786,50,43,256,0.0
7412.96,834,784,50,43,254,0.0
7425.56,833,781,52,42,253,-0.0333
7439.23,836,786,50,42,255,0.0
7451.71,832,784,48,41,254,0.0
7465.19,836,786,50,43,255,0.0
7477.71,832,784,48,43,254,0.0
7490.41,834,787,47,42,256,0.0
7502.98,836,787,49,42,255,0.0
7515.37,831,783,48,43,254,0.0
7528.32,837,788,49,42,255,0.0
7540.85,833,783,50,43,254,0.0
7553.67,837,786,51,42,255,0.0
7566.16,833,784,49,43,254,0.0
7578.56,832,784,48,42,254,0.0
7591.62,836,787,49,43,255,0.0
7604.15,834,783,51,43,254,0.0
7617.44,835,789,46,42,255,0.0
7629.9,833,784,49,43,254,0.0
7642.51,832,783,49,43,253,0.0
7656.14,836,787,49,42,255,0.0
7668.57,834,784,50,42,254,0.0
7682.22,836,787,49,42,255,0.0
7694.73,833,785,48,42,254,0.0
7707.33,837,781,56,42,254,0.0
7720.2,837,786,51,43,255,0.0
7732.63,833,783,50,42,254,0.0
7745.56,834,785,49,43,255,0.0
7758.08,833,784,49,42,253,0.0
7771.02,837,785,52,43,255,0.0
7783.51,833,784,49,43,254,0.0
7795.89,827,784,43,42,254,0.0
7809.0,836,786,50,42,255,0.0
7821.51,833,784,49,42,254,0.0
7834.77,836,788,48,43,255,0.0
7847.24,833,784,49,41,254,0.0
7859.91,830,781,49,42,253,0.0
7873.48,836,788,48,42,256,0.0
7885.95,828,785,43,42,254,0.0
7899.79,837,786,51,43,255,0.0
7912.27,831,784,47,42,254,0.0
7924.86,836,788,48,42,256,0.0
7937.71,835,786,49,42,255,0.0
7950.14,832,784,48,42,254,0.0
7963.34,835,788,47,41,255,0.0
7975.89,833,785,48,41,256,0.0
7988.65,836,788,48,42,255,0.0
8001.2,833,785,48,42,254,0.0
8013.64,829,784,45,41,254,0.0
8026.75,836,787,49,42,254,0.0
8039.33,834,783,51,43,254,0.0
8052.6,837,788,49,41,255,0.0
8065.1,833,784,49,43,254,0.0
8077.68,836,784,52,42,253,0.0
8091.4,836,787,49,42,255,0.0
8103.89,833,783,50,43,254,0.0
8117.25,837,786,51,42,256,0.0
8129.78,836,784,52,43,254,0.0
8142.47,837,788,49,42,254,0.0
8154.99,839,787,52,42,255,0.0
8167.37,832,784,48,42,254,0.0
8180.27,835,785,50,42,254,0.0
8192.79,834,785,49,43,254,0.0
8205.76,835,787,48,43,255,0.0
8218.26,833,784,49,42,254,0.0
8230.67,833,783,50,42,254,0.0
8243.57,837,788,49,42,256,0.0
8256.12,832,783,49,42,253,0.0
8269.44,837,787,50,41,255,0.0
8281.94,833,781,52,42,254,0.0
8294.71,834,784,50,42,253,0.0
8307.99,836,785,51,42,255,0.0
8320.98,833,784,49,42,255,0.0
8334.71,836,787,49,43,255,0.0
8347.28,833,784,49,42,254,0.0
8360.19,831,782,49,42,253,0.0
8373.83,836,788,48,42,255,0.0
8386.52,832,783,49,42,254,0.0
8399.56,837,788,49,41,255,0.0
8412.06,833,785,48,42,255,0.0
8424.89,836,786,50,42,255,0.0
8437.4,835,785,50,43,254,-0.0333
8449.94,832,784,48,43,253,0.0
8463.07,837,786,51,41,255,0.0
8475.62,832,783,49,42,254,0.0
8489.91,836,788,48,41,255,0.0
8502.45,833,784,49,42,254,0.0
8515.17,832,783,49,41,253,0.0
8528.49,831,787,44,42,255,0.0
8540.97,833,784,49,42,254,0.0
8554.45,838,788,50,41,256,0.0
8567.02,833,783,50,43,255,0.0
8579.67,836,787,49,42,255,0.0
8592.28,837,787,50,42,255,0.0
8604.64,832,784,48,41,254,0.0
8617.65,837,786,51,42,255,0.0
8630.16,832,783,49,43,254,0.0
8643.08,837,786,51,42,255,0.0
8655.91,832,784,48,42,254,0.0
8668.49,832,783,49,43,254,0.0
8681.95,836,786,50,42,255,0.0
8694.47,831,785,46,43,254,0.0
8708.73,836,787,49,42,255,0.0
8721.27,835,784,51,42,254,0.0
8733.89,837,786,51,42,255,0.0
8746.72,836,787,49,41,255,0.0
8759.2,831,784,47,42,254,0.0
8772.67,836,787,49,42,255,0.0
8785.2,832,785,47,42,254,0.0
8798.08,837,787,50,41,255,0.0
8810.66,834,784,50,42,253,0.0
8823.4,833,781,52,43,253,0.0
8836.59,835,787,48,43,255,0.0
8849.17,834,784,50,42,254,0.0
8862.31,837,787,50,42,255,0.0
8874.82,833,785,48,43,254,0.0
8887.45,832,784,48,42,254,0.0
8901.09,837,786,51,42,255,0.0
8913.65,833,784,49,42,254,0.0
8927.12,835,788,47,42,255,0.0
8940.01,832,785,47,42,254,0.0
8952.66,836,787,49,42,255,0.0333
8965.55,835,788,47,43,254,0.0
8978.0,833,784,49,41,253,0.0
8991.59,837,787,50,42,254,-0.0333
9004.13,831,783,48,42,254,0.0
9017.0,836,788,48,41,255,0.0
9031.36,829,782,47,42,253,0.0
9047.68,837,786,51,43,255,0.0
9060.51,833,785,48,42,253,0.0
9072.95,833,783,50,42,254,0.0
9086.12,836,787,49,41,255,0.0
9098.72,833,783,50,42,254,0.0
9111.98,836,788,48,42,255,0.0
9124.48,832,784,48,42,254,0.0
9137.12,832,784,48,41,254,0.0
9150.73,836,787,49,42,255,0.0
9163.26,831,783,48,42,253,0.0
9176.71,834,785,49,42,255,0.0
9189.63,833,784,49,43,255,0.0
9202.3,837,785,52,43,255,0.0
9215.02,835,787,48,42,255,0.0
9227.48,832,784,48,43,254,0.0
9240.98,837,786,51,42,255,0.0
9253.44,832,785,47,42,254,0.0
9266.19,836,787,49,43,255,0.0
9278.63,834,785,49,42,254,0.0
9291.16,833,784,49,42,253,0.0
9303.93,837,787,50,42,255,0.0
9316.46,833,783,50,42,254,0.0
9329.57,835,788,47,41,255,0.0
9342.0,833,784,49,42,254,0.0
9354.78,832,783,49,42,254,-0.0333
9368.38,836,785,51,42,255,0.0
9380.89,834,783,51,42,255,0.0
9394.64,837,785,52,41,255,0.0
9407.09,831,784,47,42,254,0.0
9419.69,835,788,47,43,255,0.0
9432.48,836,786,50,42,255,0.0
9445.42,833,784,49,42,254,0.0
9458.26,835,787,48,42,255,0.0
9470.73,833,783,50,42,254,-0.0333
9483.51,837,787,50,42,255,0.0
9495.95,832,784,48,42,254,0.0
9508.37,833,783,50,42,254,0.0
9521.1,835,788,47,41,254,0.0
9533.59,834,782,52,42,254,0.0
9546.32,836,787,49,42,255,0.0
9558.8,832,785,47,42,254,0.0
9571.28,833,784,49,42,254,0.0
9584.03,837,787,50,42,255,0.0
9596.5,840,783,57,42,254,0.0
9609.27,835,786,49,42,254,0.0
9622.0,832,785,47,42,254,0.0
9634.39,831,784,47,42,254,0.0
9647.13,835,786,49,43,255,0.0
9659.61,833,784,49,42,254,0.0
9672.78,835,787,48,43,255,0.0
9685.23,832,784,48,42,254,0.0
9697.71,833,784,49,42,254,0.0
9710.44,831,782,49,42,254,0.0
9729.45,833,784,49,41,254,0.0
9742.18,836,787,49,42,255,0.0
9754.66,833,783,50,42,254,0.0
9767.84,837,786,51,42,255,0.0
9780.28,833,785,48,41,254,0.0
9792.81,831,783,48,42,254,0.0
9806.95,837,786,51,42,254,0.0
9819.48,833,782,51,42,253,0.0
9833.02,836,787,49,42,255,0.0
9845.46,831,783,48,41,254,0.0
9857.96,836,788,48,43,255,0.0
9870.82,838,786,52,42,255,0.0
9883.26,834,784,50,42,254,0.0
9896.24,839,787,52,42,255,0.0
9908.76,833,784,49,42,253,0.0
9921.89,831,795,36,42,255,-0.0333
9934.34,832,785,47,42,254,0.0
9946.76,833,784,49,42,254,0.0
9959.61,836,786,50,41,255,0.0
9972.39,833,784,49,43,254,0.0
9985.26,837,786,51,43,255,0.0
9997.72,833,785,48,42,254,0.0333
10010.22,830,783,47,42,254,0.0
10023.92,836,787,49,43,255,0.0
10036.39,833,784,49,42,254,0.0
10049.85,837,787,50,42,255,0.0
10062.29,831,784,47,41,253,0.0
10074.91,832,783,49,42,253,0.0
10088.54,837,787,50,43,256,0.0
10100.99,832,785,47,43,254,0.0
10114.38,836,787,49,42,255,0.0333
10129.01,833,784,49,42,254,0.0
10142.19,836,788,48,42,255,-0.0333
10154.63,834,781,53,42,255,0.0
10167.24,834,784,50,42,254,0.0
10180.81,836,787,49,41,255,0.0
10193.31,832,784,48,41,254,0.0
10207.65,836,786,50,42,256,0.0
10220.39,835,784,51,42,254,0.0
10233.18,836,788,48,43,255,0.0
10245.71,835,786,49,43,254,0.0
10258.15,834,784,50,42,254,0.0
10271.16,837,786,51,43,255,0.0
10283.72,831,785,46,41,254,0.0
10296.55,835,787,48,42,255,0.0
10309.1,833,784,49,41,254,0.0
10321.49,832,784,48,41,254,-0.0333
10334.37,838,784,54,42,255,0.0
10346.89,832,784,48,42,254,0.0
10360.31,834,788,46,42,255,0.0
10373.07,833,784,49,43,254,0.0
10385.69,833,784,49,43,254,0.0
10399.35,837,787,50,42,255,0.0
10417.53,830,781,49,41,253,0.0
10431.48,836,787,49,42,255,0.0
10444.71,832,784,48,42,254,0.0
10457.52,836,787,49,42,255,0.0
10470.04,835,787,48,42,255,0.0
10482.7,835,786,49,43,255,0.0
10495.57,835,787,48,42,254,0.0
10508.02,832,783,49,42,254,0.0
10521.01,836,787,49,41,255,0.0
10533.54,837,787,50,42,254,0.0
10546.16,835,788,47,42,255,0.0
10559.01,834,787,47,41,255,0.0
10571.46,831,784,47,41,254,0.0
10584.36,836,787,49,41,255,0.0
10596.86,835,785,50,42,255,0.0
10609.55,833,785,48,42,255,0.0
10622.42,835,785,50,43,255,0.0
10634.91,831,784,47,42,253,0.0
10647.78,835,788,47,41,255,0.0
10660.28,836,787,49,42,255,0.0
10672.99,835,788,47,42,254,-0.0333
10685.86,834,787,47,43,254,0.0
10698.34,833,783,50,42,254,0.0
10711.26,836,787,49,42,255,0.0
10723.78,836,787,49,43,256,0.0
10736.5,837,786,51,42,255,-0.0333
10749.41,828,784,44,42,254,0.0
10761.9,830,781,49,41,253,0.0
10775.03,837,787,50,42,255,0.0
10787.5,832,784,48,43,254,0.0
10800.67,836,787,49,42,254,0.0
10813.07,832,784,48,41,254,0.0
10825.7,832,784,48,42,253,0.0333
10839.35,837,787,50,42,255,0.0
10851.83,833,784,49,42,253,0.0
10865.54,836,786,50,41,255,0.0
10878.05,833,784,49,41,255,0.0
10890.71,836,787,49,43,255,0.0
10903.62,835,787,48,42,255,0.0
10916.02,833,784,49,42,254,0.0
10929.28,835,788,47,42,255,0.0
10941.79,834,782,52,43,255,0.0
10954.61,836,787,49,43,255,0.0
10967.12,833,785,48,41,254,0.0
10980.04,835,786,49,41,254,0.0
10992.76,835,788,47,43,255,0.0
11005.31,833,783,50,42,254,0.0
11018.53,836,792,44,41,255,0.0
11036.81,835,783,52,43,254,-0.0333
11050.38,837,788,49,42,255,0.0
11062.91,834,787,47,43,255,0.0
11075.56,831,783,48,42,254,0.0333
11089.58,836,787,49,42,254,0.0
11102.15,833,784,49,43,254,0.0
11115.74,837,788,49,43,256,0.0
11128.33,836,787,49,42,255,0.0
11141.14,837,787,50,41,255,0.0
11154.0,834,786,48,43,255,0.0
11166.56,833,785,48,43,254,0.0
11179.45,838,787,51,41,255,0.0
11192.03,832,784,48,42,254,0.0
11205.57,836,788,48,42,254,0.0
11218.14,832,784,48,43,255,-0.0333
11230.88,832,784,48,42,254,0.0
11244.72,835,787,48,41,255,0.0
11257.46,832,784,48,41,254,0.0
11270.57,831,791,40,41,255,0.0
11283.15,835,787,48,42,255,0.0
11295.81,837,786,51,42,255,0.0
11308.7,834,784,50,42,253,0.0
11321.28,831,781,50,42,253,-0.0333
11334.65,837,786,51,41,255,0.0
11347.19,831,783,48,42,254,0.0
11360.58,836,788,48,43,253,0.0
11373.16,833,784,49,43,254,0.0
11385.82,832,782,50,41,254,0.0
11399.05,835,787,48,43,255,0.0
11411.52,832,784,48,42,254,0.0
11425.07,836,787,49,41,255,0.0
11437.61,833,784,49,42,254,0.0
11450.34,837,788,49,41,256,0.0
11462.9,837,785,52,42,255,0.0
11475.4,831,784,47,42,254,0.0
11488.42,835,788,47,42,255,0.0
11500.97,833,782,51,42,254,0.0
11513.8,836,786,50,43,255,0.0
11526.34,831,785,46,42,255,0.0
11538.85,831,783,48,42,254,0.0
11551.68,837,787,50,42,256,0.0
11564.18,832,784,48,42,254,0.0
11577.25,827,787,40,43,255,0.0
11589.87,834,785,49,42,254,0.0
11602.43,830,783,47,41,253,0.0
11615.96,835,786,49,42,255,0.0
11628.49,830,785,45,42,254,0.0
11641.84,837,786,51,42,255,0.0
11654.37,835,784,51,42,254,0.0
11667.07,832,783,49,42,254,0.0
11680.43,836,787,49,43,255,0.0
11692.9,833,782,51,41,253,0.0
11706.36,837,787,50,42,255,0.0
11718.96,834,784,50,42,254,0.0
11731.67,836,787,49,42,256,0.0
11744.26,835,786,49,42,255,0.0
11756.68,833,783,50,43,255,0.0
11769.73,837,785,52,42,255,0.0
11782.29,828,779,49,41,253,0.0
11797.14,837,787,50,42,255,0.0
11810.06,831,780,51,41,254,1.0
11823.06,832,785,47,47,254,7.2667
11836.16,835,787,48,48,255,11.1333
11848.74,832,783,49,47,253,10.3667
11862.25,837,787,50,44,255,6.7667
11874.78,832,784,48,42,254,3.6667
11887.52,836,786,50,43,255,1.4
11900.13,841,786,55,42,256,-0.0333
11912.46,832,784,48,42,254,-0.5
11925.72,836,785,51,43,255,-0.4667
11938.27,830,781,49,42,253,-0.1
11951.39,836,787,49,42,255,0.3
11964.03,833,783,50,42,253,0.4667
11976.66,832,784,48,43,254,0.5
11990.6,836,783,53,43,255,0.3667
12003.23,832,783,49,42,254,0.2
12016.93,837,788,49,42,255,0.0667
12029.49,833,784,49,42,255,0.0333
12042.14,833,787,46,42,255,0.0333
12055.44,835,787,48,42,255,0.0667
12067.93,833,784,49,42,254,0.1
12080.95,831,787,44,42,254,0.1333
12093.49,832,783,49,42,254,0.1
12106.62,837,787,50,41,255,0.1
12119.17,834,784,50,41,255,0.1
12131.76,833,784,49,42,254,0.0667
12144.6,835,787,48,42,255,0.0333
12157.41,832,783,49,42,254,0.0333
12170.81,831,787,44,42,255,0.0333
12183.35,833,784,49,42,254,0.0667
12195.95,832,784,48,42,254,0.0667
12209.73,836,786,50,42,255,0.0333
12222.61,833,783,50,42,254,0.0333
12236.12,836,786,50,42,255,0.0333
12248.75,832,784,48,42,254,0.0333
12261.44,837,792,45,42,255,0.0333
12274.39,837,787,50,42,255,0.0333
12286.76,830,783,47,43,254,0.0333
12299.94,836,788,48,42,255,0.0333
12312.45,835,784,51,41,253,0.0333
12325.25,837,786,51,41,256,0.0
12337.76,835,784,51,41,254,0.0333
12350.27,839,784,55,42,255,0.0
12363.06,836,787,49,41,255,0.0333
12375.61,832,783,49,41,253,0.0
12389.5,835,788,47,42,255,0.0333
12402.02,834,784,50,42,254,0.0333
12414.64,833,785,48,42,254,0.0333
12428.4,833,786,47,43,255,0.0333
12441.01,832,779,53,42,254,0.0
12454.91,836,785,51,42,255,0.0
12468.19,831,783,48,42,254,0.0
12481.51,833,784,49,43,255,0.0
12494.17,833,784,49,41,254,0.0333
12507.11,832,783,49,42,254,0.0333
12520.79,837,785,52,42,255,0.0333
12533.41,833,784,49,41,254,0.0333
12547.01,836,787,49,43,254,0.0333
12559.59,831,784,47,42,254,0.0333
12572.57,833,787,46,42,255,0.0333
12585.56,835,787,48,43,255,0.0333
12598.09,833,784,49,42,254,0.0333
12611.14,837,788,49,42,255,0.0333
12623.71,832,784,48,43,253,0.0333
12636.49,836,786,50,43,255,0.0333
12649.07,832,784,48,41,254,0.0333
12661.99,834,784,50,43,254,0.0
12674.99,839,786,53,43,255,0.0333
12687.55,830,783,47,42,254,0.0333
12700.83,837,788,49,42,255,0.0333
12713.35,833,784,49,42,254,0.0333
12725.97,833,784,49,42,254,0.0333
12740.2,836,786,50,42,254,0.0333
12752.71,829,784,45,42,254,0.0667
12766.28,837,786,51,42,255,0.1333
12778.85,831,784,47,42,254,0.3333
12791.53,833,787,46,42,255,0.7
12804.32,835,787,48,42,255,1.2
12816.86,832,784,48,41,254,1.7667
