time_ms,temp_0,temp_1,temp_0_1,diff_p,abs_p,sfm3300
0.91,817,772,45,42,251,0.0
13.13,824,780,44,41,252,0.0
25.23,814,771,43,41,249,0.0
40.98,819,775,44,42,251,0.0
53.31,812,776,36,42,252,0.0
65.55,821,776,45,41,252,-0.0333
78.08,820,776,44,40,252,0.0
91.13,824,779,45,43,253,0.0
103.32,821,779,42,41,252,0.0
115.19,823,780,43,41,253,0.0
126.98,823,779,44,43,252,0.0
139.02,823,779,44,41,253,0.0
150.85,817,775,42,42,251,0.0
163.98,824,780,44,42,253,0.0
175.85,824,780,44,42,253,0.0
187.62,824,779,45,41,253,0.0
199.81,825,780,45,42,254,0.0
211.69,818,775,43,41,251,0.0
223.93,824,780,44,42,253,0.0
235.81,824,780,44,41,253,0.0
247.53,823,779,44,42,252,-0.0333
259.66,823,780,43,42,253,0.0
271.56,824,780,44,42,252,0.0
283.25,824,779,45,42,251,0.0
295.3,825,779,46,41,253,0.0
307.27,819,776,43,41,251,-0.0333
319.78,825,780,45,41,253,0.0
331.67,824,780,44,41,253,0.0
343.42,824,780,44,42,252,0.0
355.69,823,780,43,41,253,0.0
367.55,820,775,45,42,251,0.0
379.51,824,779,45,41,252,0.0
391.62,824,779,45,42,253,0.0
403.46,823,779,44,41,253,0.0
415.63,824,780,44,42,252,-0.0333
427.49,824,780,44,42,253,0.0
439.24,824,779,45,42,252,0.0
451.55,824,780,44,42,252,0.0
463.42,822,775,47,42,251,0.0
475.4,825,779,46,42,253,0.0
487.26,823,779,44,41,252,0.0
499.05,819,775,44,42,251,0.0
511.32,825,780,45,41,253,0.0
523.19,820,776,44,42,252,0.0
535.24,824,780,44,41,253,0.0
547.45,824,779,45,42,253,0.0
559.27,817,775,42,40,251,0.0
572.28,824,780,44,43,253,0.0
584.11,824,779,45,42,252,0.0
596.05,819,775,44,41,251,0.0
608.71,830,781,49,41,253,0.0
621.13,824,777,47,41,252,0.0
636.87,831,782,49,41,253,0.0
649.38,831,781,50,42,253,0.0
661.99,827,775,52,41,251,-0.0333
675.47,830,781,49,42,252,0.0
688.0,826,778,48,42,252,0.0
700.9,832,777,55,41,254,0.0
713.38,827,778,49,42,251,0.0
726.07,830,782,48,41,253,0.0
738.49,827,779,48,42,252,0.0
750.83,826,779,47,42,252,0.0
763.75,830,782,48,42,254,0.0
776.2,827,779,48,42,252,0.0
788.91,832,782,50,42,251,0.0
801.7,827,779,48,42,252,0.0
814.18,826,778,48,42,251,0.0
827.23,829,781,48,42,254,0.0
839.7,827,777,50,42,252,0.0
853.42,832,782,50,42,253,0.0
865.86,828,779,49,42,252,0.0
878.45,823,775,48,42,252,0.0
892.1,830,782,48,41,253,0.0
904.59,827,779,48,41,252,0.0
918.14,825,776,49,43,251,0.0
931.46,827,779,48,43,252,0.0
944.14,831,782,49,42,253,0.0
956.82,830,782,48,43,253,0.0
969.19,829,773,56,41,253,0.0
982.11,830,780,50,42,253,0.0
994.57,827,777,50,41,252,0.0
1007.3,829,781,48,41,253,0.0
1019.9,827,778,49,42,252,0.0
1032.14,824,777,47,42,251,-0.0333
1045.38,829,781,48,43,253,0.0
1057.96,825,777,48,41,252,0.0
1070.95,829,781,48,41,253,0.0
1083.26,826,777,49,42,252,0.0
1095.52,827,771,56,42,252,0.0
1108.86,828,780,48,41,253,0.0
1121.27,825,777,48,42,252,0.0
1135.02,831,781,50,42,254,0.0
1147.55,826,778,48,42,253,0.0
1160.17,829,778,51,41,251,0.0
1173.75,830,782,48,42,254,0.0
1186.6,828,779,49,42,252,0.0
1199.96,830,782,48,42,253,0.0
1212.48,827,778,49,42,252,0.0
1225.12,830,782,48,41,254,0.0
1237.77,831,782,49,42,253,0.0
1250.14,827,779,48,41,252,0.0
1263.07,830,781,49,41,253,0.0
1275.58,822,784,38,41,253,0.0
1288.31,831,782,49,42,253,0.0
1300.81,827,779,48,42,252,-0.0333
1313.29,827,779,48,42,252,0.0
1326.34,830,782,48,42,253,0.0
1338.87,827,777,50,42,252,0.0
1352.75,828,780,48,42,254,0.0
1365.26,823,786,37,42,253,0.0
1377.91,827,779,48,42,252,0.0
1391.76,830,781,49,42,253,0.0
1404.34,827,779,48,42,252,0.0
1417.78,830,782,48,42,254,0.0
1430.33,827,779,48,40,252,0.0
1443.04,831,782,49,42,254,0.0
1455.71,829,775,54,43,253,0.0
1468.04,826,778,48,43,252,0.0
1480.97,830,782,48,42,253,0.0
1493.49,827,778,49,41,252,0.0
1506.27,827,777,50,42,252,0.0
1519.15,826,778,48,41,252,0.0
1531.94,825,778,47,41,252,0.0
1545.33,832,776,56,42,253,0.0
1557.89,829,778,51,42,253,0.0
1571.56,830,782,48,43,254,0.0
1584.46,827,778,49,41,252,0.0
1597.57,825,776,49,41,252,0.0
1611.43,829,782,47,42,253,0.0
1624.86,827,778,49,41,252,0.0
1637.67,830,781,49,42,254,0.0
1650.22,831,781,50,41,253,0.0
1662.85,830,781,49,42,254,0.0
1675.7,830,781,49,43,253,0.0
1688.22,827,778,49,42,252,0.0
1701.24,831,782,49,42,253,0.0
1713.86,829,781,48,42,253,0.0
1726.51,829,789,40,42,253,0.0
1739.34,830,781,49,42,253,0.0
1751.91,829,778,51,42,252,0.0
1764.89,830,782,48,42,253,0.0
1777.4,829,782,47,41,253,0.0
1790.07,826,779,47,41,253,0.0
1802.96,827,782,45,41,254,0.0
1815.44,827,777,50,42,251,0.0
1829.09,831,782,49,42,253,0.0
1841.67,831,781,50,42,252,0.0
1854.48,831,782,49,43,254,0.0
1866.94,830,781,49,42,253,0.0
1879.43,826,777,49,42,252,0.0
1892.29,830,782,48,42,253,0.0
1904.79,828,774,54,42,252,0.0
1917.75,830,781,49,41,254,0.0
1930.16,827,777,50,41,252,0.0
1942.61,824,777,47,41,251,0.0
1955.72,830,782,48,42,253,0.0
1968.21,829,778,51,43,253,0.0
1981.66,830,781,49,42,253,0.0
1994.11,827,779,48,42,252,0.0
2006.72,827,777,50,42,252,0.0
2020.28,830,782,48,41,253,0.0
2032.7,828,778,50,42,252,0.0
2046.13,831,782,49,42,253,0.0
2058.57,827,779,48,42,252,0.0333
2071.26,830,782,48,43,253,0.0
2084.1,829,781,48,41,253,0.0
2096.44,827,778,49,42,252,0.0
2109.67,828,779,49,41,252,0.0
2122.4,831,777,54,42,251,0.0
2135.1,831,782,49,42,254,0.0
2147.65,827,779,48,42,252,0.0
2160.1,827,778,49,42,252,0.0
2172.9,828,780,48,42,253,0.0
2185.38,828,779,49,41,251,0.0
2198.06,831,781,50,41,253,0.0
2210.52,827,779,48,42,253,0.0
2222.92,827,778,49,42,251,0.0
2235.64,829,782,47,42,253,0.0
2248.1,828,776,52,42,252,0.0
2260.82,831,782,49,43,253,0.0
2273.23,827,779,48,41,252,0.0
2291.8,830,782,48,41,253,0.0
2304.7,828,779,49,42,252,0.0
2317.14,827,778,49,42,252,0.0
2330.22,831,782,49,41,253,0.0
2342.77,827,778,49,41,252,0.0
2355.89,825,783,42,42,253,0.0
2368.77,824,778,46,42,252,0.0
2381.45,826,778,48,42,252,0.0
2395.01,831,782,49,42,253,0.0
2407.58,828,778,50,43,252,0.0
2421.27,830,782,48,42,254,0.0
2433.85,827,779,48,42,252,0.0
2446.56,831,784,47,41,254,0.0
2459.26,829,781,48,42,253,0.0
2471.67,828,778,50,42,252,0.0
2484.7,830,782,48,42,253,0.0
2497.22,827,777,50,42,252,0.0
2510.03,830,782,48,43,253,0.0
2522.53,828,778,50,43,252,0.0
2534.91,827,778,49,42,253,0.0
2547.87,830,782,48,41,253,0.0
2560.42,827,778,49,42,252,0.0
2573.85,830,781,49,42,253,0.0
2586.69,827,778,49,41,253,-0.0333
2599.33,827,777,50,42,252,0.0
2613.03,829,781,48,42,253,0.0
2625.62,826,778,48,43,254,0.0
2639.09,830,782,48,42,254,0.0
2652.01,826,779,47,42,252,0.0
2664.73,830,782,48,42,253,0.0
2677.48,828,781,47,42,253,0.0
2690.08,825,778,47,41,251,0.0
2703.56,830,781,49,42,254,0.0
2716.1,827,780,47,42,252,0.0
2731.84,830,781,49,42,253,0.0
2744.3,827,778,49,42,252,0.0
2756.9,824,776,48,43,251,0.0
2770.39,829,780,49,42,253,0.0
2782.8,827,777,50,42,252,0.0
2796.23,829,780,49,43,253,0.0
2808.68,825,778,47,41,252,0.0
2821.39,830,781,49,42,254,0.0
2834.16,830,781,49,41,253,0.0
2846.5,825,777,48,41,252,0.0
2859.73,826,783,43,42,253,0.0
2872.3,827,778,49,42,252,0.0
2885.03,830,780,50,42,253,0.0
2897.51,829,780,49,42,252,0.0
2912.25,829,780,49,41,253,0.0
2925.18,829,781,48,42,253,0.0
2937.77,828,780,48,42,252,0.0
2950.57,829,786,43,42,253,0.0
2963.14,826,777,49,41,252,0.0
2975.89,829,780,49,42,253,0.0
2988.88,830,780,50,43,253,0.0
3001.47,829,780,49,42,253,0.0
3014.21,829,780,49,43,253,0.0
3026.72,823,777,46,40,252,0.0
3039.29,823,783,40,42,253,0.0
3051.88,828,781,47,42,253,0.0
3064.18,828,780,48,42,253,0.0
3076.96,823,781,42,42,253,0.0
3089.27,825,777,48,42,252,0.0
3101.73,828,780,48,41,253,0.0
3114.06,828,781,47,42,253,-0.0333
3126.2,828,779,49,42,252,0.0
3139.04,828,780,48,43,253,0.0
3151.39,825,777,48,42,252,0.0
3163.78,828,780,48,41,253,0.0
3176.17,828,781,47,42,253,0.0
3188.37,828,780,48,42,253,0.0
3201.24,829,780,49,42,253,0.0
3213.53,825,777,48,41,252,0.0
3225.92,829,780,49,41,253,0.0
3238.3,829,780,49,41,253,0.0
3250.71,829,780,49,43,253,0.0
3263.46,830,781,49,41,254,0.0
3275.96,826,778,48,42,252,0.0
3288.54,828,781,47,41,253,0.0
3301.33,830,781,49,43,253,0.0
3313.81,829,781,48,41,253,0.0
3326.52,828,781,47,42,253,0.0
3339.47,823,775,48,43,251,0.0
3351.67,824,779,45,42,253,0.0
3363.54,820,779,41,40,252,0.0
3377.11,821,774,47,42,252,0.0
3390.15,818,772,46,42,251,-0.0333
3402.34,815,773,42,42,250,0.0
3422.09,819,775,44,41,252,0.0
3434.49,819,775,44,42,251,-0.0333
3446.72,818,775,43,41,251,0.0
3459.03,822,773,49,43,250,0.0
3473.35,821,779,42,41,252,0.0
3485.72,829,778,51,41,253,0.0
3497.48,820,775,45,42,251,0.0
3510.43,822,779,43,42,252,0.0
3522.26,818,775,43,41,251,0.0
3534.22,823,779,44,41,253,-0.0333
3546.49,823,778,45,41,251,-0.0333
3558.24,819,774,45,42,251,0.0
3571.29,824,779,45,42,252,0.0
3583.11,824,780,44,41,251,0.0
3594.83,819,778,41,42,252,0.0
3607.08,823,779,44,41,253,0.0
3618.97,822,778,44,42,252,0.0
3631.07,823,780,43,42,252,0.0
3642.96,817,773,44,42,250,0.0
3655.04,823,778,45,42,252,0.0
3667.09,823,779,44,41,253,0.0
3678.94,818,774,44,41,251,0.0
3690.85,822,777,45,42,252,0.0
3702.7,823,778,45,41,252,0.0
3714.39,823,778,45,41,253,0.0
3726.47,823,779,44,41,253,0.0
3738.32,822,779,43,42,251,0.0
3750.02,822,778,44,42,252,0.0
3762.35,822,779,43,41,253,0.0
3774.2,822,778,44,42,252,0.0
3786.28,824,779,45,42,252,0.0
3798.13,823,779,44,41,253,0.0
3809.88,822,779,43,42,252,0.0
3821.95,823,779,44,42,252,0.0
3833.83,817,774,43,42,251,0.0
3845.71,823,779,44,42,253,0.0
3857.56,823,779,44,42,252,0.0
3869.31,822,779,43,43,252,0.0
3881.46,824,779,45,41,253,0.0
3893.31,823,778,45,41,250,0.0
3905.08,823,778,45,43,252,0.0
3917.34,823,779,44,41,253,0.0
3929.21,822,778,44,42,252,0.0
3941.34,816,777,39,42,253,0.0
3953.19,824,779,45,42,253,0.0
3964.88,823,778,45,41,252,0.0
3976.91,823,780,43,42,253,-0.0333
3988.79,819,775,44,40,251,0.0
4000.71,823,779,44,41,253,0.0
4012.58,827,778,49,42,252,0.0
4024.31,823,778,45,41,252,0.0
4036.44,825,779,46,41,253,0.0
4048.31,831,778,53,42,251,0.0
4060.78,830,780,50,42,253,0.0
4073.45,829,781,48,42,253,0.0
4085.97,825,779,46,41,252,0.0
4098.68,831,781,50,42,253,0.0
4111.21,828,778,50,42,252,0.0
4123.64,827,780,47,42,253,0.0
4136.39,831,781,50,42,253,0.0
4148.9,829,780,49,42,253,0.0
4161.41,826,780,46,41,253,0.0
4173.71,824,775,49,42,252,0.0
4186.1,826,780,46,42,253,0.0
4198.58,828,780,48,42,253,0.0
4210.86,821,783,38,41,253,0.0
4223.38,828,780,48,42,253,0.0
4235.65,823,777,46,41,252,0.0
4247.85,827,780,47,43,253,0.0
4260.35,831,781,50,42,253,0.0
4272.64,823,776,47,41,252,0.0
4285.25,829,781,48,41,253,0.0
4297.55,828,780,48,41,253,0.0333
4312.17,828,780,48,41,252,0.0
4324.91,825,778,47,41,251,0.0
4337.47,828,780,48,41,252,0.0
4349.99,829,780,49,42,253,0.0
4362.45,826,778,48,42,252,0.0
4374.99,829,780,49,43,253,0.0
4388.02,829,781,48,43,253,0.0
4400.62,828,780,48,41,253,0.0
4413.4,830,780,50,41,253,0.0
4425.89,826,784,42,41,252,0.0
4438.45,829,780,49,42,253,0.0
4451.1,821,778,43,41,252,0.0
4463.01,822,773,49,42,252,0.0
4475.06,823,779,44,41,253,0.0
4486.92,818,774,44,42,251,0.0
4498.83,819,780,39,40,252,0.0
4510.67,821,775,46,41,249,-0.0333
4522.56,823,778,45,41,251,0.0
4534.63,824,774,50,42,251,0.0
4546.48,819,775,44,41,252,0.0
4558.46,822,778,44,41,252,0.0
4570.43,821,779,42,42,251,0.0
4582.25,823,778,45,42,252,0.0
4594.34,822,779,43,42,252,0.0
4606.18,817,774,43,41,254,0.0
4617.83,823,779,44,41,252,0.0
4630.03,822,776,46,41,252,0.0
4643.99,823,778,45,41,252,0.0
4661.08,824,779,45,41,252,0.0
4672.94,819,775,44,42,251,0.0
4684.97,823,779,44,42,253,0.0
4696.82,822,779,43,42,253,0.0
4708.57,822,778,44,42,252,0.0
4720.91,823,779,44,42,252,0.0
4732.75,824,776,48,41,251,0.0
4744.65,822,779,43,41,253,0.0
4756.67,825,779,46,41,253,0.0
4768.55,823,779,44,42,252,0.0
4780.71,824,780,44,42,253,0.0
4792.61,824,780,44,43,253,0.0
4804.34,822,779,43,41,252,0.0
4816.54,824,780,44,41,253,0.0
4828.39,821,776,45,41,251,0.0
4840.39,827,779,48,41,253,0.0
4852.51,824,780,44,41,253,0.0
4864.54,820,774,46,42,251,0.0
4877.0,824,784,40,41,253,0.0
4888.92,823,779,44,43,254,0.0
4900.96,824,780,44,41,253,0.0
4912.91,825,782,43,41,251,0.0
4924.7,820,775,45,42,251,0.0
4937.4,824,780,44,41,253,0.0
4949.33,824,779,45,43,253,0.0
4961.35,823,781,42,41,253,0.0
4973.74,824,780,44,42,253,0.0
4985.62,821,777,44,41,252,0.0
4998.7,824,780,44,40,253,0.0
5010.65,819,775,44,41,251,0.0
5023.04,819,775,44,42,251,0.0
5036.04,825,780,45,41,253,0.0
5047.91,821,776,45,42,251,0.0
5060.98,825,780,45,42,253,0.0
5072.88,823,779,44,42,251,0.0
5084.87,820,775,45,42,251,0.0
5097.38,824,780,44,41,253,0.0
5109.19,821,775,46,42,249,0.0
5122.5,824,780,44,42,253,0.0
5134.39,823,778,45,43,252,0.0
5146.26,828,777,51,43,252,0.0
5159.87,831,782,49,42,253,0.0
5172.35,827,777,50,42,252,0.0
5185.43,829,782,47,42,253,0.0
5197.95,829,781,48,42,253,0.0
5210.54,827,777,50,41,252,0.0
5223.45,829,780,49,42,253,0.0
5236.06,829,779,50,42,253,0.0
5249.56,831,781,50,42,253,0.0
5262.09,830,781,49,41,253,0.0
5274.73,827,778,49,42,252,0.0
5288.52,830,782,48,42,254,0.0
5301.27,827,777,50,41,252,0.0
5314.26,829,780,49,42,252,0.0
5326.81,831,781,50,42,253,0.0
5339.52,828,780,48,42,253,0.0
5352.45,829,781,48,43,253,0.0
5365.01,825,778,47,42,252,0.0
5378.13,831,782,49,42,253,0.0
5390.68,830,781,49,41,253,0.0
5403.51,831,782,49,42,253,0.0
5416.38,831,781,50,42,253,0.0
5428.92,827,778,49,43,252,0.0
5442.13,830,780,50,41,253,0.0
5454.68,827,779,48,41,252,0.0
5468.28,832,782,50,42,253,0.0
5480.79,826,778,48,42,252,0.0
5493.44,827,777,50,42,251,0.0
5506.88,830,783,47,43,253,0.0
5519.34,827,778,49,42,252,0.0
5532.83,831,782,49,43,253,-0.0667
5545.3,828,778,50,42,252,0.0
5557.95,831,782,49,42,254,0.0
5570.83,831,781,50,42,254,0.0
5583.16,827,778,49,42,252,0.0
5596.34,823,782,41,42,251,0.0
5608.85,827,779,48,42,252,0.0
5621.62,831,781,50,42,254,0.0
5634.11,828,779,49,42,252,0.0
5646.56,829,779,50,42,252,0.0
5659.34,830,782,48,42,254,0.0
5671.96,827,777,50,41,252,-0.0333
5685.37,831,781,50,42,254,0.0
5697.95,827,778,49,42,252,0.0
5710.79,827,778,49,42,252,0.0
5724.57,831,782,49,42,254,0.0
5737.15,828,778,50,43,252,0.0
5750.57,831,782,49,41,253,0.0
5763.11,828,778,50,43,252,0.0
5775.76,829,783,46,42,253,0.0
5788.35,831,782,49,42,253,0.0
5800.67,827,778,49,42,252,-0.0333
5814.11,831,781,50,41,253,0.0
5826.61,827,778,49,42,252,0.0
5839.29,828,779,49,43,253,0.0
5852.25,829,778,51,42,252,0.0
5864.75,831,779,52,43,251,0.0
5877.78,832,782,50,43,253,0.0
5890.34,827,777,50,42,252,0.0
5904.18,829,781,48,43,253,0.0
5916.7,828,778,50,42,252,0.0
5929.32,827,778,49,42,252,0.0
5942.95,831,782,49,42,253,0.0
5955.51,828,778,50,43,252,0.0
5969.47,829,782,47,44,253,0.0
5982.06,828,779,49,42,252,0.0
5994.73,831,782,49,42,253,0.0
6007.33,830,782,48,42,253,0.0
6019.76,827,778,49,41,252,0.0
6032.75,831,782,49,43,253,0.0
6045.26,827,776,51,41,253,-0.0333
6058.09,828,780,48,42,253,0.0
6070.58,828,779,49,42,252,0.0
6083.04,827,778,49,41,252,0.0
6096.31,829,781,48,43,254,0.0
6108.88,827,778,49,42,252,0.0
6122.13,830,781,49,43,253,0.0
6134.62,828,777,51,41,252,0.0
6147.27,828,777,51,42,252,0.0
6160.99,831,781,50,42,253,0.0
6173.5,828,778,50,42,253,0.0
6187.13,830,781,49,43,254,0.0
6199.65,828,779,49,42,252,0.0
6212.44,831,782,49,43,253,0.0
6225.06,826,782,44,41,256,0.0
6237.45,827,778,49,42,251,0.0
6254.1,831,782,49,40,253,0.0
6267.2,828,779,49,41,252,0.0
6280.87,830,784,46,41,254,0.0
6293.41,830,781,49,42,254,0.0
6306.18,826,777,49,42,254,-0.0333
6319.43,831,781,50,42,254,0.0
6332.05,827,779,48,42,253,0.0
6344.96,830,781,49,41,254,0.0
6357.52,830,781,49,42,254,0.0
6370.25,828,780,48,41,253,0.0
6382.71,829,782,47,42,253,0.0
6395.05,824,774,50,42,252,0.0
6407.99,829,781,48,42,253,0.0
6420.43,829,781,48,41,253,0.0
6432.99,830,782,48,42,253,0.0
6445.28,829,781,48,41,253,0.0
6457.56,825,777,48,40,252,0.0
6471.01,830,781,49,42,254,0.0
6483.58,831,781,50,43,253,0.0
6496.24,831,784,47,42,254,0.0
6509.12,830,781,49,42,253,0.0
6521.68,827,778,49,42,252,0.0
6534.76,831,782,49,42,253,0.0
6547.33,831,782,49,43,253,0.0
6560.18,830,780,50,41,254,0.0
6573.11,831,781,50,42,253,0.0
6585.68,827,784,43,41,253,0.0
6598.69,830,782,48,42,254,0.0
6611.27,828,778,50,42,253,-0.0333
6624.81,831,781,50,42,253,0.0
6637.35,830,780,50,43,253,0.0
6649.97,827,778,49,41,252,0.0
6663.7,831,781,50,41,253,0.0
6676.63,827,779,48,41,252,0.0
6690.12,828,778,50,42,253,-0.0333
6702.95,827,779,48,42,252,0.0
6715.87,825,776,49,41,252,0.0
6729.35,823,784,39,40,252,0.0
6742.21,828,779,49,41,253,0.0
6754.83,827,779,48,42,252,0.0
6767.39,822,776,46,41,252,0.0333
6779.37,819,775,44,41,252,0.0
6792.41,823,779,44,42,253,-0.0333
6804.58,820,775,45,41,251,0.0
6817.12,825,779,46,41,253,-0.0333
6828.92,821,775,46,42,252,0.0
6841.69,824,780,44,42,253,0.0
6853.57,824,780,44,41,253,0.0
6865.37,820,775,45,42,251,0.0
6878.27,823,779,44,41,253,0.0
6890.17,824,780,44,41,253,0.0
6902.24,823,780,43,41,253,0.0
6914.15,824,780,44,42,253,0.0
6925.95,819,775,44,42,251,0.0
6938.74,825,779,46,41,253,0.0
6950.67,820,776,44,41,251,-0.0333
6962.72,823,778,45,41,252,0.0
6974.6,824,780,44,42,252,0.0
6986.46,820,775,45,41,252,0.0
6998.65,824,780,44,41,253,0.0
7010.55,822,776,46,41,251,0.0
7022.57,825,780,45,41,253,-0.0333
7034.44,824,780,44,42,253,0.0
7046.27,820,776,44,42,251,0.0
7059.37,824,779,45,41,253,0.0
7071.27,823,780,43,40,251,0.0
7083.28,821,776,45,42,251,0.0
7096.11,825,780,45,42,253,0.0
7108.33,816,775,41,41,252,0.0
7121.37,824,780,44,41,253,0.0
7133.25,820,776,44,42,252,0.0
7145.22,825,780,45,41,252,-0.0333
7157.53,824,779,45,41,253,0.0
7169.51,820,775,45,42,252,0.0
7182.29,825,780,45,41,253,0.0
7194.17,823,776,47,41,251,0.0
7206.11,818,777,41,41,253,0.0
7219.22,824,780,44,41,252,-0.0333
7230.99,821,775,46,42,252,0.0
7244.12,825,780,45,42,253,0.0
7255.99,824,780,44,40,252,0.0
7267.81,820,774,46,42,251,-0.0333
7280.39,823,779,44,42,253,0.0
7292.21,820,775,45,41,251,0.0
7304.57,824,780,44,42,253,0.0
7316.46,826,780,46,42,253,0.0
7328.26,819,775,44,42,251,0.0
7341.25,824,783,41,41,253,0.0
7353.19,818,776,42,41,251,-0.0333
7365.24,826,780,46,41,253,0.0
7377.15,827,779,48,42,253,0.0
7388.97,820,775,45,41,251,0.0
7402.21,822,780,42,42,253,0.0
7414.09,816,771,45,40,250,0.0
7426.04,825,780,45,41,253,0.0
7437.9,824,780,44,41,253,0.0
7449.66,816,773,43,41,250,0.0
7462.65,825,780,45,42,253,0.0
7474.67,828,779,49,42,252,0.0
7487.27,827,779,48,41,252,0.0
7501.68,832,781,51,42,253,0.0
7514.22,828,779,49,41,253,0.0
7527.81,829,782,47,42,254,0.0
7540.28,828,779,49,42,252,0.0
7553.04,831,782,49,42,254,0.0
7566.25,828,779,49,42,252,0.0
7578.71,828,778,50,42,252,0.0
7591.92,827,781,46,41,253,0.0
7604.46,828,778,50,42,252,0.0
7617.68,831,781,50,42,253,0.0
7630.19,827,780,47,42,252,0.0333
7642.78,825,779,46,41,252,0.0
7656.52,829,778,51,41,253,0.0
7669.12,827,779,48,42,253,0.0
7682.63,831,782,49,42,255,0.0
7695.14,828,778,50,41,252,0.0
7707.84,831,782,49,42,253,0.0
7720.43,831,779,52,43,253,0.0
7732.8,827,778,49,41,252,0.0
7746.02,830,782,48,42,253,0.0
7758.56,825,775,50,42,251,0.0
7773.11,830,781,49,42,250,0.0
7786.78,831,779,52,41,253,0.0
7803.69,832,782,50,43,253,0.0
7816.15,828,778,50,41,253,0.0333
7832.71,832,782,50,42,253,0.0
7845.29,832,782,50,42,254,0.0
7857.68,831,780,51,42,253,0.0
7870.69,830,781,49,42,254,0.0
7883.3,830,781,49,42,253,0.0
7895.78,830,781,49,43,253,0.0
7908.06,827,778,49,42,253,0.0
7920.32,828,781,47,42,253,0.0
7932.8,830,782,48,43,254,0.0
7945.07,827,778,49,42,251,0.0
7957.67,829,781,48,43,253,0.0
7969.97,826,777,49,41,253,0.0
7982.25,827,777,50,41,252,-0.0333
7995.06,831,781,50,42,253,0.0
8007.59,824,780,44,41,252,0.0
8020.41,830,782,48,42,253,0.0
8032.92,829,779,50,41,252,0.0
8045.33,827,779,48,41,252,0.0
8058.43,831,781,50,41,253,0.0
8070.96,828,777,51,42,252,0.0
8084.31,831,782,49,43,254,0.0
8096.8,827,779,48,42,253,0.0
8109.36,827,777,50,43,252,0.0
8123.04,830,782,48,42,253,0.0
8135.54,829,778,51,43,252,0.0
8149.24,832,782,50,42,254,0.0
8161.75,828,778,50,41,252,0.0
8174.59,830,781,49,42,253,0.0
8187.46,826,781,45,42,251,0.0
8200.07,828,778,50,42,253,0.0
8212.96,831,781,50,42,254,0.0
8225.47,825,777,48,41,252,0.0
8238.33,831,782,49,42,253,0.0
8250.81,827,778,49,42,251,0.0
8263.3,828,778,50,42,252,0.0
8276.31,831,781,50,42,254,-0.0333
8288.86,828,778,50,42,252,0.0
8302.3,831,782,49,42,253,0.0
8314.79,828,779,49,41,253,0.0
8327.37,827,778,49,42,252,0.0
8340.92,830,781,49,42,253,0.0
8353.47,827,777,50,41,252,0.0
8367.07,826,782,44,42,251,0.0
8379.55,827,779,48,42,252,0.0
8392.19,831,782,49,41,253,0.0
8405.01,831,782,49,42,254,0.0
8417.39,827,778,49,43,252,0.0
8430.3,831,781,50,42,253,0.0
8442.83,826,776,50,41,251,0.0
8455.79,827,776,51,41,252,0.0
8469.08,828,778,50,42,252,0.0
8481.62,828,779,49,42,252,0.0
8494.6,830,789,41,42,254,0.0333
8507.15,827,778,49,41,252,0.0
8520.4,831,782,49,41,253,0.0
8532.91,829,779,50,42,252,0.0
8545.5,828,779,49,42,252,0.0
8558.98,831,781,50,42,253,0.0
8571.58,827,778,49,42,252,0.0
8585.31,831,782,49,42,254,0.0
8597.84,828,779,49,43,252,0.0
8610.42,831,782,49,42,253,0.0
8623.35,828,779,49,42,253,-0.0333
8635.78,828,778,50,43,253,0.0
8648.69,831,782,49,41,253,0.0
8661.29,830,777,53,42,252,-0.0333
8674.14,830,780,50,42,253,0.0
8686.66,827,778,49,41,252,0.0
8699.08,827,779,48,42,252,0.0
8712.2,830,781,49,42,254,0.0
8724.73,828,778,50,42,252,0.0333
8737.93,831,782,49,41,254,0.0
8750.44,827,779,48,42,252,0.0
8762.98,828,776,52,41,252,0.0
8776.55,830,781,49,42,253,0.0
8789.11,824,776,48,42,252,0.0
8802.93,830,782,48,42,253,0.0
8815.45,827,779,48,42,253,0.0
8828.01,831,782,49,42,254,0.0
8840.91,831,782,49,42,254,0.0
8853.38,831,779,52,42,250,0.0333
8866.32,832,782,50,42,253,0.0
8878.82,826,779,47,41,252,0.0
8891.72,832,782,50,43,254,-0.0333
8904.2,827,779,48,42,252,0.0
8916.59,828,779,49,42,252,0.0
8929.57,831,778,53,41,253,0.0
8942.14,827,778,49,42,252,0.0
8955.37,831,782,49,42,253,0.0
8967.87,828,778,50,41,252,0.0
8980.5,827,777,50,42,252,0.0
8994.25,833,781,52,42,254,0.0
9006.78,827,778,49,42,253,0.0
9020.22,832,782,50,43,253,0.0
9032.75,828,779,49,42,253,0.0
9045.4,831,782,49,43,253,0.0
9057.97,831,782,49,41,253,0.0
9070.4,829,776,53,42,252,0.0
9083.5,831,781,50,42,253,0.0
9095.98,827,778,49,41,252,0.0
9108.84,830,781,49,42,253,-0.0333
9121.42,828,778,50,41,252,0.0
9133.88,827,777,50,43,252,0.0
9146.85,830,780,50,42,253,-0.0333
9159.39,827,779,48,41,253,0.0
9172.66,828,779,49,42,253,-0.0333
9185.18,827,778,49,41,252,0.0
9197.82,828,777,51,41,252,0.0
9211.44,831,781,50,41,253,0.0
9223.97,828,779,49,40,252,0.0
9237.46,831,782,49,42,253,0.0
9249.99,831,779,52,41,252,0.0
9262.63,830,782,48,42,253,0.0
9275.21,831,781,50,41,253,0.0
9287.59,828,778,50,42,252,0.0
9300.74,831,780,51,41,254,0.0
9313.22,827,777,50,41,252,0.0
9326.05,831,782,49,42,253,0.0
9338.52,828,779,49,42,253,0.0
9350.88,828,779,49,43,252,0.0
9363.8,831,781,50,42,253,0.0
9376.4,828,772,56,41,252,0.0
9389.63,828,779,49,42,254,0.0
9402.23,827,779,48,42,252,0.0
9414.84,828,778,50,42,252,0.0
9428.38,830,782,48,42,253,0.0
9440.88,828,778,50,42,252,0.0
9454.45,830,781,49,42,254,0.0
9466.96,828,779,49,41,252,0.0
9479.53,831,781,50,43,253,0.0
9492.46,831,780,51,42,254,0.0
9504.96,829,779,50,43,252,0.0
9517.9,831,782,49,42,254,-0.0333
9530.41,826,779,47,42,253,0.0
9543.37,831,782,49,41,254,0.0
9555.86,827,783,44,42,253,-0.0333
9568.24,828,778,50,41,252,0.0
9581.56,831,782,49,41,253,0.0
9594.08,827,778,49,42,252,0.0
9607.22,831,782,49,42,253,0.0
9619.73,826,779,47,42,252,0.0
9632.31,827,777,50,42,252,0.0
9645.68,826,781,45,43,253,0.0
9658.2,829,778,51,42,252,0.0333
9671.86,832,782,50,43,254,0.0333
9684.37,828,778,50,42,252,0.0333
9697.0,828,777,51,41,252,0.0333
9710.4,831,781,50,42,253,0.0
9722.87,828,779,49,42,252,0.0
9736.37,831,783,48,42,253,0.0
9748.91,828,779,49,42,252,0.0
9761.63,832,782,50,41,253,0.0333
9774.22,831,781,50,42,253,0.0333
9786.6,827,778,49,42,252,0.0
9799.87,831,781,50,43,254,0.0
9812.43,825,776,49,42,252,0.0
9825.46,831,781,50,42,255,0.0
9838.08,828,779,49,42,253,0.0
9850.63,827,777,50,42,252,0.0
9864.14,830,781,49,42,254,0.0
9876.65,827,779,48,43,252,0.0
9890.11,831,781,50,42,253,0.0
9902.67,828,779,49,42,253,0.0
9915.33,831,779,52,41,252,0.0333
9928.47,831,782,49,44,253,0.0
9940.93,829,778,51,42,252,0.0
9954.49,831,781,50,41,253,0.0333
9967.0,828,779,49,41,252,0.0333
9979.68,832,782,50,42,253,0.0333
9992.96,830,779,51,40,251,0.0333
10005.71,826,778,48,40,252,0.0
10019.39,828,779,49,43,252,0.0
10032.28,825,776,49,42,252,-0.0333
10045.98,829,776,53,42,252,0.0
10058.92,823,775,48,42,251,0.0
10071.61,829,779,50,42,253,0.0
10084.46,828,779,49,42,253,0.0
10096.92,822,776,46,40,252,0.0
10109.53,822,775,47,41,251,0.0
10122.27,820,775,45,42,251,0.0
10134.52,825,780,45,42,253,0.0
10146.41,825,780,45,42,253,-0.0333
10158.2,820,775,45,42,251,0.0
10170.87,825,780,45,41,253,0.0
10182.76,819,775,44,41,252,0.0
10194.79,825,780,45,41,253,0.0
10206.7,824,779,45,40,253,0.0
10218.66,823,776,47,41,251,0.0
10231.76,825,780,45,42,253,0.0
10243.65,821,776,45,41,251,0.0
10255.66,825,780,45,41,253,0.0
10268.16,825,780,45,42,253,0.0
10279.91,822,775,47,42,251,0.0
10292.69,823,779,44,42,252,0.0
10304.57,825,780,45,41,251,0.0
10316.37,820,774,46,42,251,0.0
10329.22,825,784,41,42,253,0.0
10341.28,821,774,47,41,251,0.0
10353.87,825,780,45,41,253,0.0
10365.72,825,779,46,42,251,0.0
10377.5,820,775,45,42,251,0.0
10390.14,822,780,42,41,253,0.0
10402.08,816,775,41,42,250,0.0
10414.04,824,780,44,41,253,0.0
10425.86,824,779,45,41,254,0.0
10437.67,815,777,38,41,251,0.0333
10450.37,825,780,45,41,252,0.0
10462.18,821,775,46,41,251,0.0
10474.22,832,774,58,41,252,0.0
10486.17,826,780,46,41,253,0.0
10497.96,820,775,45,42,251,0.0
10509.96,824,783,41,41,253,0.0
10521.94,825,779,46,41,253,0.0
10533.85,820,774,46,42,251,0.0
10546.39,825,781,44,42,252,0.0
10558.26,821,775,46,42,252,0.0
10570.3,824,780,44,42,253,0.0
10582.25,826,781,45,42,251,0.0
10594.08,820,777,43,42,252,0.0
10607.05,821,779,42,41,252,0.0
10618.94,821,775,46,43,250,0.0
10630.89,822,780,42,42,253,0.0
10643.19,824,780,44,42,253,0.0
10654.94,820,773,47,42,251,0.0
10668.04,823,778,45,43,253,0.0
10679.92,825,779,46,42,252,0.0
10692.02,820,774,46,41,250,0.0
10705.01,825,780,45,42,253,-0.0333
10717.08,821,776,45,42,252,0.0
10730.08,824,780,44,42,252,0.0
10742.02,826,780,46,42,253,0.0
10759.04,823,779,44,42,253,0.0
10770.97,826,780,46,42,252,0.0
10782.95,820,773,47,41,250,0.0
10795.65,825,780,45,42,253,0.0
10807.58,832,782,50,42,254,0.0
10820.47,828,778,50,41,253,0.0
10834.66,832,781,51,42,253,0.0333
10847.56,829,779,50,41,253,0.0333
10861.25,832,781,51,42,253,0.0333
10874.05,832,782,50,41,253,0.0
10887.01,831,782,49,42,254,0.0
10900.45,831,782,49,42,253,0.0
10913.37,825,778,47,41,251,0.0
10926.06,830,781,49,42,253,0.0
10938.51,826,778,48,43,251,0.0333
10952.16,830,781,49,42,253,0.0
10964.55,829,781,48,42,253,0.0
10977.11,823,777,46,43,251,0.0
10990.11,829,778,51,42,253,0.0
11002.41,827,778,49,42,253,0.0333
11015.07,831,782,49,42,253,0.0
11027.62,831,781,50,42,253,0.0
11040.41,827,777,50,41,252,0.0
11053.64,830,781,49,42,253,0.0
11066.21,828,778,50,42,254,0.0
11079.2,831,781,50,42,253,0.0
11091.85,830,781,49,41,253,0.0
11104.55,831,781,50,43,254,0.0
11117.44,831,782,49,42,253,0.0
11130.02,829,778,51,42,252,0.0
11142.99,830,782,48,42,254,0.0
11155.58,831,781,50,42,253,0.0
11168.33,831,782,49,43,253,0.0
11181.23,831,781,50,41,253,0.0
11194.04,828,778,50,42,254,0.0333
11207.07,830,781,49,42,253,0.0333
11220.18,828,778,50,42,252,0.0333
11233.81,830,781,49,42,253,0.0
11246.16,829,781,48,42,253,0.0
11258.61,827,777,50,42,252,0.0333
11272.17,830,781,49,42,253,0.0333
11284.51,825,777,48,42,252,0.0333
11297.77,830,781,49,42,253,0.0333
11310.15,827,780,47,42,253,0.0
11322.57,827,777,50,42,252,0.0
11336.64,831,782,49,41,253,0.0
11349.15,828,778,50,42,252,0.0
11362.63,831,781,50,42,253,-0.0333
11375.18,831,781,50,42,254,0.0333
11387.9,827,779,48,42,253,0.0333
11401.4,827,779,48,42,252,0.0333
11414.06,827,778,49,41,252,0.0333
11427.62,831,776,55,42,254,0.0
11440.28,828,779,49,41,252,0.0333
11454.7,832,782,50,42,253,0.0333
11467.24,828,779,49,42,252,0.0333
11479.93,831,781,50,42,254,0.0
11492.9,828,779,49,42,252,0.0
11505.38,828,778,50,40,252,0.0
11519.35,830,781,49,41,254,0.0
11531.96,829,779,50,42,253,0.0
11545.28,832,782,50,42,254,0.0
11557.81,829,779,50,41,252,0.0
11570.58,827,777,50,43,250,0.0
11583.93,831,781,50,42,253,0.0
11596.43,828,779,49,42,252,0.0
11609.96,833,782,51,42,253,0.0
11622.54,828,779,49,43,253,0.0
11635.63,831,782,49,41,254,0.0
11648.26,828,778,50,42,252,0.0
11660.79,831,779,52,41,252,0.0
11673.57,831,782,49,42,253,0.0
11686.28,829,777,52,42,252,0.0
11699.59,832,779,53,42,253,0.0
11712.18,828,778,50,41,253,0.0
11724.86,828,779,49,42,252,0.0
11738.34,832,782,50,41,253,0.0
11750.86,818,777,41,42,252,0.0
11764.63,830,781,49,42,254,0.0333
11777.19,827,778,49,42,253,0.0
11789.85,831,781,50,42,254,0.0333
11803.37,831,781,50,42,253,0.0333
11816.03,828,779,49,42,252,0.0
11828.99,831,782,49,41,254,0.0
11841.57,831,778,53,42,253,0.0333
11854.38,831,782,49,41,254,0.0333
11866.89,828,779,49,42,252,0.0333
11881.4,826,776,50,42,252,0.0333
11895.47,831,781,50,42,255,0.0333
11908.16,828,777,51,42,251,0.0333
11921.84,830,781,49,42,253,0.0
11934.12,827,778,49,40,253,0.0
11946.56,830,780,50,40,253,0.0
11958.88,830,781,49,42,253,0.0
11971.06,826,777,49,42,252,0.0
11983.74,830,781,49,43,253,0.0333
11996.05,827,778,49,42,251,0.0
12008.53,830,781,49,42,253,0.0
12020.93,830,782,48,41,254,0.0
12033.28,828,777,51,42,252,0.0
12046.55,831,782,49,41,254,0.0333
12059.08,828,779,49,41,253,0.0
12071.94,832,782,50,43,253,0.0333
12084.48,829,779,50,41,252,0.0333
12097.05,828,778,50,42,252,0.0
12110.24,831,781,50,41,254,0.0333
12122.79,826,776,50,42,252,0.0333
12136.27,831,781,50,42,253,0.0
12148.8,823,779,44,42,252,0.0
12161.45,828,778,50,42,251,0.0
12175.19,830,782,48,42,253,0.0
12187.65,828,779,49,42,253,0.0
12201.66,832,782,50,42,251,0.0
12214.2,827,778,49,41,253,0.0
12227.37,833,782,51,42,253,0.0
12239.89,826,777,49,41,252,0.0
12252.74,827,778,49,41,252,0.0
12266.07,831,782,49,42,253,0.0
12278.63,829,779,50,41,252,0.0
12292.4,831,782,49,43,253,0.0
12304.93,828,778,50,42,252,0.0333
12317.51,830,782,48,42,253,0.0
12330.46,827,778,49,41,255,0.0333
12343.68,823,777,46,41,252,0.0
12356.96,830,781,49,41,253,0.0
12369.43,827,777,50,42,251,0.0
12382.14,831,781,50,41,253,0.0
12394.83,827,779,48,42,252,0.0
12407.32,825,775,50,41,252,0.0
12420.95,831,781,50,42,252,0.0
12433.41,828,778,50,42,252,0.0
12446.66,830,781,49,42,253,0.0333
12459.13,828,778,50,42,252,0.0
12471.77,827,771,56,42,252,0.0
12485.59,829,780,49,42,253,0.0
12498.09,827,777,50,42,252,0.0
12511.25,830,781,49,41,253,0.0
12523.7,826,776,50,41,252,0.0
12536.75,831,781,50,41,253,0.0
12549.18,827,777,50,42,252,0.0
12565.37,826,776,50,42,251,0.0
12579.03,830,780,50,41,253,0.0
12592.53,827,777,50,42,252,0.0
12605.48,830,781,49,42,253,0.0
12618.02,827,777,50,41,252,0.0
12630.96,831,779,52,42,253,0.0
12643.46,831,781,50,41,253,0.0
12656.05,825,774,51,43,252,0.0
12668.95,825,780,45,42,253,0.0
12681.52,828,778,50,42,252,0.0
12694.7,830,781,49,43,253,0.0
12707.15,827,778,49,42,252,0.0
12719.75,831,781,50,41,253,0.0
12732.48,830,780,50,42,253,0.0
12744.82,827,777,50,42,252,0.0
12757.65,830,780,50,42,253,0.0
12770.12,827,777,50,42,252,0.0
12782.81,831,781,50,42,253,0.0
12795.29,830,781,49,42,253,0.0
12807.7,828,777,51,40,252,0.0
12820.63,830,781,49,41,253,0.0
12833.27,826,776,50,42,252,0.0
12846.04,830,780,50,42,253,-0.0333
12858.57,830,780,50,41,253,0.0
12870.92,827,776,51,41,251,0.0
12884.31,831,780,51,41,253,0.0
12896.84,827,776,51,42,252,0.0
12910.16,830,779,51,43,253,0.0
12922.68,827,775,52,41,251,0.0
12935.34,827,776,51,42,251,0.0
12948.89,829,780,49,42,254,0.0
12961.37,827,778,49,42,252,0.0
12974.47,830,781,49,41,253,-0.0333
12987.0,826,777,49,42,252,0.0
12999.84,830,780,50,41,253,0.0
13012.4,830,782,48,43,253,0.0
13024.78,827,778,49,42,251,0.0
13038.08,831,781,50,42,253,0.0
13050.61,827,777,50,42,252,0.0
13064.0,829,780,49,41,252,0.0
13076.48,827,778,49,41,253,0.0
13089.13,826,775,51,41,250,0.0333
13102.66,831,780,51,42,255,0.0
13115.09,828,779,49,42,252,0.0
13128.34,830,781,49,42,253,0.0
13140.86,826,777,49,42,252,0.0333
13153.54,830,781,49,42,253,0.0
13166.38,831,781,50,41,254,0.0
13178.74,828,778,50,42,252,0.0
13192.09,831,781,50,41,253,0.0
13206.82,825,774,51,42,251,0.0
13220.55,828,777,51,41,252,0.0
13234.71,822,775,47,42,251,0.0
13249.78,826,777,49,42,252,0.0
13262.61,822,774,48,42,251,0.0
13275.51,825,777,48,42,251,0.0
13287.86,827,778,49,42,252,0.0
13300.07,832,778,54,41,252,0.0
13312.57,823,775,48,42,251,0.0
13325.2,826,777,49,41,252,0.0
13337.65,826,780,46,43,254,0.0
13350.42,825,779,46,42,252,0.0
13362.22,817,772,45,42,251,0.0
13374.51,824,779,45,42,253,0.0
