time_ms,temp_0,temp_1,temp_0_1,diff_p,abs_p,sfm3300
0.72,820,777,43,42,251,0.0
12.91,823,780,43,42,253,0.0
24.79,820,775,45,41,252,0.0
36.99,819,776,43,41,251,0.0
50.08,821,776,45,42,251,0.0
62.98,820,775,45,43,251,0.0
76.15,819,775,44,41,252,0.0
88.6,820,775,45,41,252,0.0
105.96,819,780,39,41,253,0.0
118.28,825,781,44,41,253,0.0
130.45,824,781,43,41,253,0.0
142.36,824,780,44,43,253,0.0
155.0,820,777,43,42,251,0.0
167.44,824,781,43,41,251,0.0
179.35,827,780,47,41,253,0.0
191.15,825,781,44,41,253,0.0
203.1,823,786,37,42,253,0.0
215.52,818,777,41,42,252,0.0
228.28,823,780,43,42,253,0.0
240.17,823,788,35,42,253,0.0
252.08,823,781,42,41,253,0.0
264.28,824,780,44,42,252,0.0
276.09,824,787,37,42,253,0.0
288.15,822,779,43,41,253,0.0333
300.21,823,780,43,41,253,0.0
312.03,818,776,42,41,252,0.0
324.76,824,780,44,41,253,0.0
336.67,823,778,45,41,251,0.0
349.16,821,778,43,42,254,0.0
361.63,825,781,44,42,253,0.0
373.52,820,775,45,42,252,0.0
386.3,825,781,44,42,253,0.0
398.23,824,781,43,42,253,0.0
410.33,821,778,43,41,253,0.0
422.8,825,781,44,42,253,0.0
434.72,821,778,43,41,252,0.0
447.85,825,781,44,40,253,0.0
459.75,824,780,44,41,253,0.0
471.82,821,776,45,40,251,0.0
484.5,824,781,43,42,253,0.0
496.29,820,778,42,41,252,0.0
508.95,824,779,45,43,254,0.0
520.85,825,780,45,43,253,0.0
532.87,821,777,44,41,251,0.0
545.63,823,784,39,42,253,0.0
557.44,824,781,43,42,253,0.0
569.49,826,781,45,42,253,0.0
581.66,826,781,45,41,253,0.0
593.46,819,775,44,42,251,0.0
606.27,825,781,44,42,253,0.0
618.21,825,781,44,42,253,0.0
630.18,824,782,42,42,253,0.0
642.08,825,782,43,42,253,0.0
653.95,823,777,46,41,252,0.0
666.38,825,781,44,42,253,0.0
678.3,824,781,43,42,253,0.0
690.34,825,778,47,41,251,0.0
702.64,824,781,43,42,254,0.0
714.45,822,778,44,41,251,0.0
727.57,825,781,44,41,253,0.0
739.46,823,780,43,42,252,0.0
751.51,820,776,44,42,251,0.0
764.05,826,780,46,41,253,0.0333
776.09,820,778,42,42,252,0.0
788.75,825,782,43,42,253,0.0
800.66,825,781,44,42,253,0.0
812.39,821,777,44,42,252,0.0
825.26,826,781,45,42,253,0.0
837.24,826,780,46,42,253,0.0
849.31,825,781,44,42,253,0.0
861.14,824,782,42,41,253,0.0
872.9,824,780,44,43,253,0.0333
884.92,825,782,43,42,253,0.0
896.78,819,776,43,43,252,0.0
908.68,826,781,45,41,253,0.0
920.54,825,781,44,42,253,0.0
932.27,823,780,43,42,253,0.0
944.35,831,782,49,43,254,0.0
956.98,828,780,48,42,253,0.0
969.68,828,779,49,42,253,0.0
982.37,831,782,49,41,254,0.0
994.89,831,781,50,43,254,0.0
1007.67,831,783,48,43,254,0.0
1020.13,829,780,49,42,253,0.0
1032.79,831,782,49,42,253,0.0
1045.62,828,782,46,42,253,0.0
1058.17,828,781,47,42,253,0.0
1070.66,828,782,46,42,253,0.0
1082.97,825,779,46,43,252,0.0
1095.34,828,781,47,42,253,0.0
1107.83,829,780,49,43,253,0.0
1120.18,828,779,49,42,252,0.0
1132.69,830,781,49,41,254,0.0
1144.98,824,777,47,42,252,0.0
1157.41,823,782,41,40,251,0.0
1169.85,829,782,47,41,254,0.0
1182.17,828,781,47,43,253,0.0
1194.64,830,781,49,42,253,0.0
1206.91,826,778,48,42,252,0.0
1219.34,828,781,47,42,253,0.0
1231.83,829,782,47,42,253,0.0
1244.14,828,781,47,41,253,0.0
1256.65,829,782,47,41,253,0.0
1269.01,826,779,47,42,252,0.0
1281.5,830,780,50,42,253,0.0
1294.05,830,781,49,42,254,0.0
1306.43,830,780,50,42,253,0.0
1319.02,830,775,55,42,254,0.0
1331.32,826,777,49,41,252,0.0
1343.7,827,781,46,42,253,0.0
1356.16,827,782,45,42,253,0.0
1368.54,826,782,44,43,252,0.0
1381.13,830,782,48,42,253,0.0
1393.44,825,779,46,42,252,0.0
1405.82,827,782,45,42,253,0.0
1418.38,829,782,47,41,253,0.0
1430.72,829,780,49,42,253,0.0
1443.2,829,782,47,42,253,0.0
1455.66,825,777,48,41,253,0.0
1468.2,830,780,50,42,253,0.0
1480.74,829,782,47,43,256,0.0
1493.12,829,780,49,41,253,0.0
1505.61,830,779,51,42,253,0.0
1517.99,825,778,47,41,252,0.0
1530.36,829,781,48,42,253,0.0
1542.87,828,780,48,41,254,0.0
1555.42,828,780,48,42,253,0.0
1568.02,830,782,48,42,252,0.0
1580.31,827,779,48,41,252,0.0
1592.73,829,782,47,43,253,0.0
1605.29,830,783,47,42,254,0.0
1617.64,830,782,48,42,253,0.0
1630.1,828,781,47,41,254,0.0
1642.38,826,777,49,41,253,0.0
1654.76,831,780,51,42,253,0.0
1667.38,825,783,42,42,253,0.0
1679.75,829,779,50,42,253,0.0
1692.18,829,781,48,42,253,0.0
1704.49,824,778,46,41,251,0.0
1717.05,827,782,45,42,253,0.0
1729.64,829,782,47,41,253,0.0
1741.96,828,780,48,42,253,0.0
1754.49,825,776,49,43,252,0.0
1767.6,826,777,49,42,253,0.0
1780.14,830,782,48,42,253,0.0
1792.59,830,782,48,42,254,0.0
1804.89,828,781,47,41,254,0.0
1817.79,831,783,48,41,253,0.0
1830.1,826,779,47,41,252,0.0
1842.46,829,783,46,42,252,0.0
1854.84,828,782,46,41,253,-0.0333
1867.04,827,778,49,42,253,0.0
1880.19,830,781,49,42,254,0.0
1892.47,827,778,49,42,252,0.0
1904.91,830,782,48,42,253,0.0
1917.46,829,782,47,42,253,0.0
1929.69,826,779,47,41,252,0.0
1942.72,828,782,46,42,253,0.0
1955.04,827,780,47,42,252,0.0
1967.59,827,784,43,41,254,0.0
1980.58,830,782,48,43,254,0.0
1993.01,827,779,48,42,252,0.0
2006.34,829,782,47,41,253,0.0
2018.86,827,779,48,42,252,0.0
2031.68,831,781,50,41,253,0.0
2044.66,829,780,49,41,252,0.0
2058.25,829,782,47,42,253,0.0
2070.9,828,782,46,41,253,0.0
2083.42,830,782,48,41,253,0.0
2096.22,828,783,45,42,253,0.0
2108.67,826,778,48,42,252,0.0
2121.28,828,779,49,42,253,0.0
2134.47,831,783,48,42,254,0.0
2147.07,830,779,51,43,256,0.0
2160.03,824,781,43,42,253,0.0
2171.9,821,777,44,41,252,0.0
2183.83,825,783,42,43,253,0.0
2195.69,825,781,44,42,254,0.0
2207.41,824,780,44,42,253,0.0
2219.51,824,781,43,42,253,0.0
2231.37,825,778,47,41,252,0.0
2243.25,824,780,44,43,253,0.0
2255.46,825,781,44,41,253,0.0
2267.36,825,780,45,42,253,0.0
2279.41,826,781,45,42,253,0.0
2291.22,824,783,41,42,253,0.0
2302.98,824,780,44,43,253,0.0
2315.05,824,782,42,42,253,0.0
2326.93,820,776,44,41,251,0.0
2338.85,826,781,45,41,253,0.0
2350.69,822,781,41,42,253,0.0
2362.43,825,780,45,42,253,0.0
2374.46,825,781,44,42,253,0.0
2386.31,825,781,44,41,251,0.0
2398.06,825,780,45,42,253,0.0
2410.28,824,781,43,42,254,0.0
2422.15,824,780,44,42,253,0.0
2434.22,825,782,43,41,253,0.0
2446.07,825,781,44,42,253,0.0
2457.81,824,780,44,42,253,0.0
2469.87,824,780,44,42,252,0.0
2481.76,819,775,44,42,252,0.0
2493.7,824,780,44,41,253,0.0
2505.55,823,780,43,40,253,0.0
2517.33,824,779,45,42,252,0.0
2529.62,826,780,46,42,253,0.0
2541.45,819,776,43,42,252,0.0
2553.45,823,780,43,42,251,0.0
2565.56,824,780,44,42,253,0.0
2577.4,823,779,44,42,252,0.0
2589.55,823,780,43,41,253,0.0
2601.41,824,780,44,41,253,0.0
2613.09,823,779,44,42,253,0.0
2625.33,824,780,44,42,253,0.0
2637.22,817,777,40,40,251,0.0
2649.23,822,780,42,41,253,0.0
2661.08,824,780,44,42,253,0.0
2672.82,824,779,45,42,253,0.0
2684.97,824,780,44,41,252,0.0
2696.83,815,775,40,41,251,0.0
2708.79,824,781,43,42,253,0.0
2720.67,824,780,44,41,253,0.0
2732.38,823,779,44,43,253,0.0
2744.56,823,779,44,42,253,0.0
2756.59,824,780,44,41,253,0.0
2768.58,824,779,45,43,252,0.0
2780.84,824,780,44,42,253,0.0
2792.72,819,776,43,42,251,0.0
2804.74,819,777,42,42,251,0.0
2819.02,823,780,43,41,252,0.0
2831.07,824,781,43,42,253,0.0
2845.58,824,781,43,42,253,0.0
2857.39,824,780,44,43,252,0.0
2869.64,827,782,45,42,253,0.0
2882.14,827,779,48,42,252,0.0
2894.56,829,781,48,42,253,0.0
2907.36,830,782,48,42,254,0.0
2919.85,828,779,49,42,253,0.0
2932.64,831,782,49,42,254,0.0
2945.11,828,779,49,41,252,0.0
2957.54,830,781,49,42,254,0.0
2970.25,830,782,48,42,252,0.0
2982.58,830,781,49,42,253,0.0
2995.1,828,781,47,42,253,0.0
3007.39,826,778,48,41,253,0.0
3019.62,824,781,43,41,253,0.0
3032.23,829,782,47,43,254,0.0
3044.56,828,781,47,43,253,0.0
3057.06,829,782,47,42,254,0.0
3069.38,827,779,48,42,252,0.0
3081.8,829,781,48,43,254,0.0
3094.53,830,782,48,41,253,0.0
3106.99,827,779,48,42,252,0.0
3119.72,824,781,43,42,252,0.0
3132.24,827,779,48,43,252,0.0
3144.64,830,781,49,43,254,0.0
3157.38,830,782,48,41,254,0.0
3169.87,826,779,47,42,252,0.0
3182.39,830,782,48,41,254,0.0
3194.66,826,778,48,42,252,0.0
3206.92,828,781,47,43,253,0.0
3219.41,829,782,47,41,253,0.0
3231.72,826,778,48,42,253,0.0
3244.37,820,772,48,42,253,0.0
3257.66,823,777,46,41,249,0.0
3275.56,829,782,47,42,253,0.0
3288.26,827,781,46,41,253,0.0
3301.41,822,776,46,41,252,0.0
3314.54,827,778,49,42,252,0.0
3327.02,823,775,48,41,251,0.0
3340.37,825,777,48,42,252,0.0
3353.57,821,773,48,42,250,0.0
3366.17,825,776,49,41,252,0.0
3378.7,819,777,42,41,252,0.0
3390.55,822,776,46,41,252,0.0
3402.45,821,775,46,42,250,0.0
3414.65,820,776,44,41,251,0.0
3426.66,820,781,39,42,253,0.0
3439.12,824,781,43,41,253,0.0
3450.83,820,775,45,42,252,0.0
3463.65,824,781,43,42,253,0.0
3475.47,824,780,44,43,251,0.0
3487.34,816,774,42,41,250,0.0
3500.49,822,780,42,42,253,0.0
3512.42,820,777,43,42,252,0.0
3525.0,824,780,44,42,253,0.0
3536.82,824,780,44,42,253,-0.0333
3548.53,820,776,44,41,252,0.0
3561.32,824,780,44,42,253,0.0
3573.13,819,775,44,42,252,0.0
3585.51,824,781,43,42,252,0.0
3597.43,824,780,44,43,253,0.0
3609.17,820,776,44,41,251,0.0
3621.99,825,780,45,41,253,0.0
3633.85,819,776,43,42,251,0.0
3645.84,825,781,44,41,252,-0.0333
3657.7,824,780,44,41,253,0.0
3669.52,820,776,44,41,251,0.0
3681.79,824,781,43,41,253,0.0
3693.62,819,776,43,40,251,0.0
3705.56,824,780,44,42,253,0.0
3717.45,824,780,44,41,253,0.0
3729.07,819,776,43,41,251,0.0
3741.71,824,780,44,41,253,0.0
3753.52,824,781,43,42,251,0.0
3765.26,819,776,43,42,251,0.0
3778.22,824,781,43,41,253,0.0
3790.01,823,780,43,42,253,0.0
3802.03,824,781,43,42,253,0.0
3813.91,823,780,43,42,253,0.0
3825.68,817,773,44,42,251,0.0
3838.59,825,780,45,42,252,0.0
3850.45,820,776,44,41,251,0.0333
3862.45,827,780,47,42,253,0.0
3874.26,824,780,44,42,253,0.0
3885.97,821,776,45,41,252,0.0
3900.3,824,780,44,42,253,0.0
3912.22,818,777,41,42,249,0.0
3924.14,825,781,44,41,253,0.0
3936.0,824,781,43,42,253,0.0
3947.71,816,776,40,41,252,0.0
3960.4,823,780,43,42,253,0.0
3972.28,824,779,45,42,252,0.0
3984.34,823,781,42,42,253,0.0
3996.55,821,780,41,40,253,0.0
4008.35,818,778,40,42,252,0.0
4021.39,822,780,42,41,253,0.0
4033.24,823,780,43,41,252,0.0333
4045.17,820,776,44,43,251,0.0
4057.9,823,780,43,42,253,0.0
4069.7,819,776,43,43,252,0.0
4083.55,830,782,48,43,253,0.0
4096.0,828,779,49,41,252,0.0
4108.57,823,772,51,42,251,0.0
4121.64,830,782,48,41,254,-0.0333
4134.11,828,779,49,42,252,-0.0333
4147.55,830,782,48,42,253,0.0
4160.01,827,779,48,42,252,0.0
4176.04,827,779,48,42,253,0.0
4188.76,827,779,48,42,253,0.0
4201.52,830,781,49,42,253,0.0
4214.23,830,782,48,42,253,0.0
4226.75,829,781,48,42,254,0.0
4239.57,831,781,50,42,254,0.0
4252.04,823,779,44,43,253,0.0
4264.61,829,780,49,42,253,0.0
4277.58,829,782,47,42,253,0.0
4290.06,829,777,52,43,254,0.0
4302.62,830,782,48,41,253,0.0
4314.93,826,778,48,42,252,0.0
4327.37,829,781,48,42,253,0.0
4339.87,829,782,47,42,253,0.0
4352.22,828,781,47,43,253,0.0
4364.77,829,782,47,42,253,0.0
4377.09,827,778,49,41,252,0.0
4389.63,829,781,48,42,253,0.0
4402.62,830,782,48,42,253,0.0
4415.2,830,780,50,43,254,-0.0333
4428.07,830,782,48,41,253,0.0
4440.55,827,779,48,41,252,0.0
4453.24,830,781,49,42,252,0.0
4465.96,830,781,49,42,253,0.0
4478.37,829,781,48,42,253,0.0
4491.16,828,782,46,42,252,0.0
4503.48,827,778,49,42,251,0.0
4515.95,829,781,48,42,253,0.0
4528.3,828,782,46,41,254,0.0
4543.55,825,778,47,42,252,0.0
4557.34,831,783,48,42,254,0.0
4570.3,825,779,46,43,252,0.0
4583.23,831,782,49,42,253,0.0
4595.6,832,784,48,42,255,0.0
4608.09,831,783,48,41,254,0.0
4620.75,830,783,47,41,253,0.0
4633.1,825,778,47,41,252,0.0
4645.89,829,782,47,42,254,0.0
4658.28,830,782,48,43,254,-0.0333
4670.83,831,783,48,41,254,0.0
4683.66,832,783,49,42,253,0.0
4696.08,828,780,48,42,252,0.0
4709.3,831,783,48,42,253,0.0
4721.84,831,782,49,42,254,0.0
4734.5,831,783,48,41,254,0.0
4747.42,831,782,49,41,253,0.0
4759.94,827,780,47,42,253,0.0
4773.25,831,783,48,42,254,0.0
4785.94,829,782,47,43,253,0.0
4798.96,830,782,48,42,254,0.0
4811.37,824,782,42,42,254,0.0
4823.63,827,779,48,42,253,0.0333
4836.57,829,782,47,42,254,0.0
4849.28,830,782,48,42,253,0.0
4861.93,830,782,48,42,254,0.0
4874.51,827,779,48,42,252,0.0
4887.09,826,779,47,42,252,0.0
4900.27,829,781,48,42,254,0.0
4912.67,827,778,49,42,252,0.0
4925.71,825,782,43,42,254,0.0
4938.08,829,779,50,42,254,0.0
4950.66,826,779,47,42,252,0.0
4964.01,829,782,47,41,254,0.0
4976.39,825,778,47,42,253,0.0
4989.95,830,783,47,42,254,0.0
5002.5,830,782,48,43,253,0.0
5015.47,828,780,48,42,253,0.0
5029.4,829,783,46,41,254,0.0
5041.84,828,779,49,42,252,0.0
5055.05,831,783,48,42,254,0.0
5067.55,827,778,49,41,252,0.0
5080.3,831,783,48,41,254,0.0
5092.77,827,778,49,43,253,0.0
5105.21,827,780,47,42,252,0.0
5118.11,831,783,48,42,254,0.0
5130.61,827,778,49,42,252,0.0
5143.88,831,783,48,42,254,0.0
5156.41,827,780,47,41,253,0.0
5169.34,825,778,47,42,252,0.0
5183.12,831,783,48,42,253,0.0
5195.58,830,779,51,41,252,0.0
5209.16,831,783,48,43,254,0.0
5221.71,828,779,49,41,252,0.0
5234.38,831,783,48,40,254,0.0
5247.1,830,782,48,41,253,0.0
5259.57,827,779,48,43,253,0.0
5272.8,831,782,49,42,254,0.0
5285.33,826,778,48,42,253,0.0
5298.29,831,783,48,42,255,0.0
5310.78,826,780,46,41,253,0.0
5323.25,826,779,47,42,252,0.0
5336.5,828,779,49,42,254,0.0
5349.11,827,779,48,42,252,0.0
5362.36,830,783,47,41,254,0.0
5374.81,828,780,48,42,253,0.0
5387.48,824,777,47,42,252,-0.0333
5401.21,830,782,48,42,254,0.0
5413.75,828,779,49,42,253,0.0
5427.39,831,783,48,42,254,0.0
5439.93,828,780,48,42,254,0.0
5452.61,831,783,48,42,254,0.0
5465.27,831,783,48,42,253,0.0
5478.63,830,780,50,41,252,0.0
5491.46,831,783,48,42,254,0.0
5504.06,829,782,47,43,254,0.0
5516.82,832,783,49,41,254,0.0
5529.74,832,782,50,41,254,0.0
5542.28,828,779,49,43,253,0.0
5555.1,828,779,49,42,253,0.0
5567.92,831,779,52,43,252,0.0
5581.12,830,783,47,41,254,0.0
5593.63,830,782,48,42,254,0.0
5606.18,824,778,46,42,252,0.0
5619.2,830,783,47,41,254,0.0
5631.66,827,778,49,42,252,0.0
5645.1,829,783,46,42,254,0.0
5657.52,830,787,43,42,251,0.0
5670.11,827,779,48,42,253,0.0
5683.11,829,783,46,42,254,0.0
5695.35,825,779,46,41,252,0.0
5707.98,831,783,48,42,253,0.0
5720.57,831,782,49,42,254,0.0
5733.21,828,779,49,42,252,0.0
5746.85,831,782,49,41,253,0.0
5759.43,827,779,48,42,253,0.0
5772.68,830,782,48,41,254,0.0
5785.25,829,782,47,42,253,0.0
5798.0,831,783,48,42,254,-0.0333
5810.88,830,782,48,42,253,0.0
5823.52,825,779,46,43,252,0.0
5836.41,829,783,46,43,254,0.0
5849.05,828,780,48,42,253,0.0
5862.51,830,781,49,43,254,0.0
5875.04,831,782,49,41,254,0.0
5887.68,828,780,48,42,253,0.0
5901.54,831,783,48,42,253,-0.0333
5914.25,827,778,49,41,252,0.0
5927.33,831,784,47,42,252,0.0
5939.88,828,779,49,41,253,0.0
5952.59,831,783,48,42,253,0.0
5965.09,831,783,48,41,253,0.0
5978.3,828,779,49,42,253,0.0
5991.1,831,783,48,43,254,0.0
6003.73,829,779,50,42,253,0.0
6016.77,838,783,55,42,253,-0.0333
6029.31,832,782,50,42,254,-0.0333
6041.87,828,779,49,42,253,0.0
6054.77,829,782,47,41,253,0.0
6067.35,828,779,49,42,253,-0.0333
6080.75,831,783,48,42,254,0.0333
6093.26,827,780,47,41,252,0.0333
6106.0,828,783,45,42,252,0.0
6119.22,831,782,49,42,254,0.0333
6131.68,828,779,49,42,253,-0.0333
6145.15,832,784,48,42,254,0.0
6157.69,828,779,49,41,253,0.0
6170.35,828,780,48,42,254,0.0
6183.08,830,782,48,42,254,0.0
6195.47,828,780,48,43,253,0.0
6208.73,829,783,46,41,253,0.0
6221.23,827,780,47,42,253,0.0
6233.97,831,782,49,42,254,0.0
6246.5,829,779,50,43,252,0.0
6259.24,828,780,48,41,253,0.0
6272.39,831,783,48,42,253,0.0333
6284.92,827,779,48,42,252,0.0
6298.35,831,783,48,42,254,0.0
6316.9,828,779,49,42,253,0.0
6330.23,832,783,49,41,253,0.0
6342.76,831,782,49,41,253,0.0
6355.37,828,780,48,42,253,0.0
6369.3,830,783,47,43,253,0.0
6381.98,828,778,50,42,253,0.0
6395.01,830,789,41,43,253,0.0
6407.59,828,782,46,42,253,0.0
6420.31,829,781,48,42,254,0.0
6432.76,829,783,46,41,253,0.0
6444.98,826,779,47,41,253,0.0
6458.04,830,782,48,41,253,0.0
6470.4,829,782,47,42,254,0.0
6482.9,830,782,48,42,254,0.0
6495.22,828,782,46,42,254,0.0
6507.47,828,779,49,42,253,0.0
6520.25,831,783,48,42,253,0.0
6532.87,831,782,49,42,253,0.0
6545.59,830,782,48,42,253,0.0
6558.48,832,781,51,41,253,0.0
6571.09,826,779,47,42,253,0.0
6584.05,830,782,48,42,254,0.0
6596.62,828,780,48,42,252,0.0
6610.85,827,782,45,42,256,0.0
6623.26,827,778,49,41,253,0.0
6635.91,825,777,48,42,252,0.0
6650.52,825,778,47,42,251,0.0
6663.87,827,780,47,42,252,0.0
6676.42,827,779,48,41,253,0.0
6689.13,827,779,48,42,252,0.0
6701.54,823,780,43,42,254,0.0
6714.05,820,776,44,41,252,0.0333
6727.04,820,776,44,42,251,0.0
6740.02,825,781,44,41,253,0.0
6751.97,825,781,44,42,253,0.0
6764.01,825,782,43,41,253,0.0333
6775.93,825,781,44,41,252,0.0
6787.74,822,776,46,42,251,0.0
6801.31,824,780,44,41,253,0.0
6813.22,824,780,44,42,252,-0.0333
6825.2,823,779,44,42,253,0.0
6837.1,823,779,44,41,253,0.0333
6849.34,820,775,45,40,247,0.0
6861.91,824,780,44,42,253,0.0333
6873.83,824,780,44,42,253,-0.0333
6885.89,820,779,41,42,252,0.1667
6897.95,824,780,44,41,253,0.0
6909.82,819,776,43,41,252,0.0333
6926.5,824,780,44,43,253,-0.0333
6938.76,819,776,43,41,251,-0.0333
6951.36,825,781,44,42,253,0.0
6963.25,826,779,47,41,253,-0.0333
6975.07,820,776,44,43,251,0.0
6988.14,822,780,42,41,253,-0.0333
7000.06,823,780,43,42,252,0.0
7012.15,825,781,44,42,254,0.0
7024.01,823,781,42,42,253,0.0
7035.83,820,776,44,42,251,0.0
7049.41,824,781,43,41,253,-0.0333
7061.34,817,780,37,42,253,0.0
7073.31,824,781,43,42,253,0.0
7085.19,822,779,43,41,253,0.0
7096.94,819,782,37,41,252,0.0
7109.15,824,780,44,40,253,0.0667
7121.08,824,780,44,43,252,0.0667
7133.17,824,779,45,42,251,0.1
7145.6,825,781,44,42,253,0.1
7157.42,820,777,43,42,251,0.1
7170.45,822,784,38,41,254,0.1333
7182.6,823,780,43,42,253,0.1333
7194.56,819,775,44,42,251,0.0667
7207.46,823,781,42,42,253,0.0
7219.29,819,776,43,42,251,0.0
7233.13,824,780,44,41,253,-0.0333
7245.02,824,780,44,42,252,-0.0333
7257.02,819,775,44,42,251,0.0
7269.66,824,781,43,41,253,0.0
7281.46,820,775,45,41,251,0.0
7294.4,824,781,43,41,253,0.0333
7306.29,824,780,44,42,253,0.0
7318.18,820,776,44,42,251,0.0
7331.15,820,775,45,40,253,0.0
7343.0,824,780,44,42,252,0.0
7355.04,824,780,44,42,253,0.0
7366.95,824,780,44,41,253,0.0
7378.7,820,775,45,42,251,0.0
7391.29,824,780,44,42,253,0.0
7403.22,822,780,42,42,253,0.0
7415.47,830,782,48,42,254,0.0
7427.97,830,782,48,42,253,0.0
7440.44,826,779,47,42,252,0.0
7454.1,829,782,47,42,253,0.0
7466.68,830,781,49,42,254,0.0
7479.44,827,782,45,42,254,0.0
7492.58,829,781,48,43,254,0.0
7505.16,827,779,48,42,252,0.0
7518.34,830,782,48,41,254,0.0
7530.9,830,781,49,43,253,0.0
7543.56,830,781,49,43,253,0.0
7556.48,829,781,48,41,253,0.0
7569.08,827,778,49,42,253,0.0
7582.47,830,782,48,41,252,-0.0333
7595.03,830,782,48,42,254,0.0
7609.77,826,779,47,42,252,0.0
7622.48,826,779,47,42,252,0.0
7634.98,828,781,47,42,253,0.0
7647.79,828,781,47,42,253,0.0
7660.14,828,781,47,41,253,0.0
7672.75,829,777,52,42,254,0.0
7685.02,827,779,48,42,252,0.0
7697.44,828,781,47,42,252,0.0
7710.14,823,781,42,42,255,0.0
7722.49,830,781,49,42,253,0.0
7735.35,831,782,49,42,254,0.0
7747.91,828,778,50,41,253,0.0
7760.51,827,779,48,42,252,0.0
7774.08,830,782,48,42,254,0.0
7786.58,824,779,45,43,252,0.0
7800.2,831,776,55,42,254,0.0
7812.64,829,779,50,42,253,0.0
7825.21,829,781,48,42,253,0.0
7838.16,830,782,48,42,254,0.0
7850.64,827,779,48,42,253,0.0
7863.58,830,782,48,43,253,0.0
7876.08,826,780,46,42,253,0.0
7888.78,831,781,50,41,253,0.0
7901.3,827,779,48,43,253,0.0
7913.93,827,779,48,41,252,0.0
7926.83,827,782,45,42,254,0.0
7939.33,826,778,48,41,252,0.0
7952.28,830,782,48,42,253,-0.0333
7964.79,828,778,50,42,252,0.0
7977.38,825,776,49,41,251,0.0
7990.59,830,782,48,41,254,0.0
8003.12,824,776,48,42,252,0.0
8016.68,826,782,44,42,254,0.0
8029.21,825,779,46,42,253,0.0
8041.84,826,778,48,42,251,0.0
8055.15,831,782,49,42,254,0.0
8067.6,828,779,49,42,253,0.0
8081.14,830,782,48,42,254,0.0
8093.65,827,779,48,42,252,0.0
8106.3,832,779,53,42,254,0.0
8118.95,831,782,49,42,253,0.0
8131.34,827,778,49,42,252,0.0
8144.47,830,782,48,42,253,-0.0333
8156.96,827,779,48,41,252,0.0
8169.64,830,779,51,42,253,0.0
8182.43,830,782,48,42,254,0.0
8194.78,831,780,51,42,252,0.0
8208.01,831,782,49,42,253,0.0
8220.51,827,779,48,42,253,0.0
8233.24,831,782,49,42,253,0.0
8245.74,827,779,48,42,252,0.0
8258.2,827,778,49,41,253,0.0
8271.02,831,781,50,41,253,0.0
8283.57,826,778,48,42,253,0.0
8296.55,825,776,49,42,253,0.0
8309.44,826,780,46,42,253,0.0
8322.07,826,777,49,42,252,0.0
8336.3,829,781,48,42,253,0.0
8349.23,825,778,47,41,252,0.0
8362.07,828,782,46,42,254,0.0
8374.41,827,781,46,41,253,0.0
8386.96,827,781,46,41,253,0.0
8399.59,828,781,47,41,253,0.0
8411.79,824,779,45,41,252,0.0
8424.44,829,782,47,42,253,0.0
8436.81,826,779,47,42,253,0.0
8449.61,827,780,47,42,253,0.0333
8462.73,827,781,46,42,253,0.0
8475.29,826,779,47,41,252,0.0
8488.33,829,781,48,41,253,0.0
8500.92,830,782,48,42,255,0.0
8513.66,830,782,48,42,254,0.0
8526.5,829,782,47,42,253,0.0
8539.21,825,778,47,42,252,0.0
8551.97,829,782,47,41,253,0.0
8564.34,829,780,49,41,253,0.0
8576.87,829,782,47,43,253,0.0
8589.21,828,780,48,41,253,0.0
8601.49,826,778,48,43,252,-0.0333
8614.23,830,782,48,42,253,0.0
8626.62,828,779,49,42,253,0.0
8639.25,830,782,48,42,254,0.0
8651.78,830,781,49,42,253,0.0
8664.27,827,778,49,41,253,0.0
8677.3,830,782,48,41,253,0.0
8689.84,826,779,47,40,252,0.0
8702.56,830,782,48,42,253,0.0
8715.41,827,779,48,41,252,0.0
8727.87,826,780,46,41,252,0.0
8740.91,831,782,49,42,253,0.0
8753.44,828,778,50,43,253,0.0
8766.8,830,782,48,42,254,0.0
8779.31,828,779,49,42,253,0.0
8791.96,828,779,49,42,253,0.0
8805.56,830,781,49,42,254,0.0
8818.11,828,779,49,41,252,0.0
8832.01,831,782,49,42,254,0.0
8844.55,828,774,54,42,252,0.0
8857.3,831,782,49,41,254,0.0
8869.93,830,782,48,42,253,0.0
8882.65,827,779,48,43,253,0.0
8895.57,829,780,49,41,254,0.0
8908.12,828,780,48,41,253,0.0
8920.86,832,783,49,42,253,0.0
8933.38,828,779,49,41,253,0.0
8945.82,826,779,47,41,253,0.0
8958.97,831,783,48,42,254,0.0
8971.5,825,777,48,41,252,0.0
8989.8,829,782,47,41,253,-0.0333
9002.39,828,779,49,41,252,0.0
9015.34,831,782,49,42,253,0.0
9027.86,831,782,49,42,254,-0.0333
9040.47,823,784,39,41,253,0.0
9053.32,829,782,47,41,254,0.0
9065.85,828,780,48,42,252,0.0
9079.03,832,783,49,42,254,0.0
9091.42,828,780,48,41,253,0.0
9104.01,827,779,48,42,252,0.0
9117.66,831,783,48,42,253,0.0
9130.18,829,780,49,42,252,0.0
9143.75,830,781,49,42,254,0.0
9156.27,827,780,47,42,253,0.0
9168.95,827,777,50,42,252,0.0
9182.42,830,782,48,43,253,0.0
9194.89,828,779,49,43,253,0.0
9208.52,831,783,48,42,253,0.0
9221.06,831,779,52,42,252,0.0
9234.35,831,784,47,42,254,0.0
9246.98,829,779,50,42,253,0.0
9259.64,827,779,48,41,252,0.0
9272.88,831,783,48,41,253,0.0
9285.43,828,779,49,41,252,0.0
9298.83,831,782,49,41,253,0.0
9311.33,831,782,49,42,251,0.0
9323.9,828,779,49,41,252,0.0
9337.48,831,782,49,42,254,0.0
9350.0,828,780,48,42,252,0.0
9364.01,831,782,49,42,254,0.0
9376.53,827,780,47,43,253,0.0
9389.16,831,783,48,42,254,0.0
9402.0,836,782,54,42,254,0.0
9414.4,828,779,49,42,253,0.0
9427.56,831,783,48,42,254,0.0
9440.06,828,780,48,42,253,0.0
9452.77,832,783,49,42,253,0.0
9465.29,831,780,51,42,253,0.0
9478.28,829,783,46,43,254,0.0
9490.94,830,783,47,42,253,0.0
9503.44,824,776,48,42,252,0.0
9516.42,831,783,48,43,254,-0.0333
9534.91,829,779,50,42,253,0.0
9548.51,831,783,48,42,254,0.0
9561.01,827,779,48,41,253,0.0
9573.65,829,778,51,42,252,0.0
9586.85,829,781,48,41,254,0.0
9599.33,836,777,59,41,252,0.0
9612.67,831,783,48,43,254,0.0
9625.16,828,778,50,42,253,0.0
9637.92,831,783,48,42,254,0.0
9650.64,831,782,49,41,254,0.0
9662.9,827,780,47,42,253,0.0
9676.13,831,782,49,42,253,0.0
9688.65,829,781,48,42,251,0.0
9701.42,832,783,49,42,254,0.0
9713.91,828,780,48,41,253,0.0
9726.35,828,779,49,41,253,0.0
9739.6,831,783,48,43,254,0.0
9752.26,826,778,48,42,252,0.0
9765.29,831,782,49,42,254,0.0
9777.66,827,779,48,41,253,0.0
9790.02,826,779,47,41,253,0.0
9803.54,830,782,48,42,252,0.0
9815.92,827,779,48,42,252,0.0
9829.43,830,783,47,42,253,0.0
9841.73,826,779,47,42,252,0.0
9854.11,827,780,47,42,254,0.0
9867.17,831,783,48,41,253,0.0
9879.56,828,779,49,42,253,0.0333
9892.91,830,783,47,42,254,0.0
9905.42,832,780,52,40,253,0.0
9918.14,831,783,48,42,253,0.0
9930.73,831,783,48,42,254,0.0
9943.49,827,780,47,42,253,0.0
9956.68,830,782,48,42,253,0.0
9969.42,828,780,48,41,252,0.0
9982.44,831,783,48,42,254,0.0
9995.31,824,775,49,41,252,0.0
10008.95,824,780,44,42,253,0.0
10021.57,828,779,49,41,253,0.0
10034.42,829,780,49,42,253,0.0
10046.92,829,780,49,42,253,0.0
10059.38,818,774,44,42,250,0.0
10072.79,822,778,44,42,252,-0.0333
10085.55,825,777,48,42,252,0.0
10097.51,821,776,45,42,251,0.0
10109.68,824,780,44,42,253,0.0
10121.57,822,783,39,41,252,0.0
10133.63,825,781,44,41,253,0.0
10145.51,823,781,42,43,253,0.0
10157.34,827,779,48,42,252,0.0
10170.26,823,782,41,41,253,0.0
10182.16,820,778,42,41,252,0.0
10194.14,819,778,41,43,253,0.0
10206.58,825,781,44,42,253,0.0
10218.34,821,776,45,41,252,0.0
10231.24,826,781,45,41,253,0.0
10243.11,824,780,44,41,252,0.0
10254.87,821,777,44,42,251,0.0
10267.75,826,781,45,41,253,0.0
10279.54,819,775,44,42,251,0.0
10291.94,824,781,43,42,253,0.0
10303.81,820,777,43,41,253,0.0
10315.54,821,776,45,41,251,0.0
10328.48,826,781,45,42,253,0.0
10340.35,820,778,42,42,252,0.0
10352.39,825,781,44,42,253,0.0
10364.31,824,780,44,42,253,0.0
10376.37,819,775,44,41,251,0.0
10388.59,826,781,45,42,253,0.0
10400.48,821,777,44,41,253,0.0
10412.49,824,780,44,42,252,0.0
10424.46,825,778,47,42,253,0.0
10436.25,822,777,45,41,252,0.0
10449.09,826,781,45,42,253,0.0
10460.95,820,777,43,41,252,0.0
10472.98,820,776,44,42,253,0.0
10485.49,825,781,44,42,254,0.0
10497.24,821,777,44,42,252,-0.0333
10510.25,825,781,44,42,253,0.0
10522.11,824,781,43,41,253,0.0
10537.88,824,782,42,42,253,0.0
10549.76,823,780,43,41,253,0.0
10561.48,820,777,43,41,252,0.0
10574.08,824,781,43,42,253,0.0
10585.96,817,777,40,41,252,0.0
10597.96,826,781,45,41,253,0.0
10609.83,824,781,43,40,253,0.0
10621.64,822,777,45,42,252,0.0
10634.57,825,781,44,42,253,0.9333
10646.46,820,778,42,42,252,3.8
10658.41,822,780,42,43,253,2.8333
10670.83,823,777,46,42,252,1.2333
10682.56,822,774,48,43,252,0.4667
10695.58,825,781,44,42,253,-0.7
10707.44,825,779,46,41,252,-0.6
10719.31,820,777,43,41,252,-0.4333
10731.99,825,780,45,43,253,-0.1333
10743.79,819,777,42,42,251,0.2333
10756.07,825,781,44,42,253,0.3
10768.0,832,782,50,43,253,0.3333
10780.37,828,779,49,43,253,0.2333
10793.78,832,783,49,42,254,0.0333
10806.31,827,778,49,42,253,-0.0333
10819.0,828,784,44,43,253,-0.0333
10831.72,831,783,48,42,254,-0.0333
10844.14,827,779,48,42,253,0.0333
10857.21,830,782,48,42,254,0.0333
10869.72,827,780,47,41,252,0.0667
10882.43,832,783,49,42,254,0.0667
10894.93,827,777,50,42,253,0.0333
10907.36,827,780,47,42,253,0.0333
10920.25,827,782,45,42,253,0.0
10932.81,828,779,49,42,252,0.0
10945.85,831,783,48,43,253,0.0333
10958.38,828,779,49,41,253,0.0
10970.96,828,780,48,42,253,0.0333
10984.1,832,782,50,41,253,0.0333
10996.61,828,779,49,43,253,0.0333
11009.98,832,783,49,41,254,0.0333
11022.49,828,780,48,40,252,0.0
11035.13,828,778,50,41,252,0.0
11048.54,831,782,49,41,254,0.0
11061.21,830,780,50,42,253,0.0333
11074.71,829,783,46,42,254,0.0
11087.02,827,777,50,42,253,0.0
11099.51,830,782,48,42,254,0.0
11111.82,828,782,46,42,254,0.0
11124.05,826,778,48,42,253,0.0333
11136.81,831,782,49,41,252,0.0
11149.15,827,780,47,43,252,0.0
11161.61,830,782,48,42,253,0.0333
11173.9,831,783,48,42,254,0.0667
11186.35,829,779,50,42,253,0.0667
11199.46,831,782,49,43,254,0.0333
11211.98,830,780,50,41,252,0.0333
11224.7,832,783,49,43,253,0.0333
11237.17,832,777,55,42,251,0.0667
11249.61,827,780,47,41,253,0.0667
11262.4,831,783,48,42,253,0.0333
11274.87,829,780,49,42,252,0.0333
11287.65,832,783,49,42,254,0.0333
11300.17,828,779,49,42,252,0.0
11312.59,827,780,47,41,253,0.0
11325.34,831,783,48,42,253,0.0333
11337.9,825,779,46,43,252,0.0333
11350.9,831,782,49,42,254,0.0333
11363.39,828,783,45,42,253,0.0667
11375.97,828,779,49,41,252,0.0333
11389.18,831,783,48,42,254,0.0333
11401.69,829,780,49,42,253,0.0
11415.02,830,781,49,41,254,0.0
11427.62,828,780,48,42,252,0.0
11440.18,827,778,49,42,252,0.0333
11453.81,831,781,50,42,255,0.0333
11466.34,828,779,49,42,253,0.0333
11479.83,830,782,48,41,253,0.0333
11492.12,825,778,47,42,252,0.0
11504.6,830,783,47,43,253,0.0
11516.93,830,782,48,42,253,0.0333
11529.12,828,779,49,42,253,0.0333
11541.75,830,782,48,42,253,0.0333
11554.08,827,780,47,41,252,0.0333
11566.59,830,782,48,42,253,0.0
11578.94,831,779,52,42,253,0.0
11591.31,828,778,50,41,252,0.0
11604.58,831,783,48,41,254,0.0
11617.11,826,780,46,41,251,0.0
11629.95,831,783,48,43,254,0.0
11642.44,828,779,49,41,253,0.0333
11654.89,828,779,49,42,253,0.0333
11667.71,831,783,48,42,254,0.0
11680.22,828,779,49,41,253,0.0
11693.19,831,783,48,42,253,0.0
11705.68,826,775,51,42,253,0.0
11718.29,826,779,47,41,252,0.0
11731.72,831,783,48,42,254,0.0
11744.34,827,779,48,41,253,0.0
11757.58,831,783,48,42,254,0.0
11770.07,829,779,50,41,251,0.0
11782.74,827,778,49,42,252,0.0
11795.82,831,783,48,42,252,0.0
11808.02,826,779,47,41,253,0.0
11821.12,830,783,47,43,253,0.0
11833.46,827,779,48,42,252,0.0
11845.9,831,783,48,42,253,0.0
11858.5,830,782,48,42,253,0.0
11870.75,827,779,48,41,252,0.0
11883.7,831,782,49,42,254,0.0
11896.19,828,776,52,42,252,0.0333
11908.75,826,777,49,43,252,0.1
11922.01,838,782,56,42,256,0.0333
11935.3,828,779,49,42,253,0.0333
11948.16,830,783,47,42,253,0.0333
11960.68,829,780,49,42,253,0.0
11973.39,831,782,49,43,253,0.0
11985.91,828,780,48,41,252,0.0333
11998.32,828,780,48,42,253,0.0333
12011.43,833,781,52,42,255,0.0333
12023.93,828,778,50,43,252,0.0
12037.07,828,783,45,42,254,0.0333
12049.65,828,780,48,41,253,0.0
12062.22,828,779,49,42,252,0.0
12075.74,832,783,49,42,254,0.0
12088.31,826,780,46,43,252,0.0333
12102.0,831,782,49,42,253,0.0333
12114.51,828,780,48,42,253,0.0333
12127.27,827,778,49,43,253,0.0333
12140.36,831,783,48,42,254,0.0333
12152.86,828,779,49,41,253,0.0333
12165.94,831,781,50,42,253,0.0
12178.47,830,780,50,42,252,0.0333
12191.17,831,784,47,42,252,0.0
12203.67,823,777,46,42,252,0.0333
12216.06,828,780,48,42,252,0.0333
12228.86,827,784,43,42,254,0.0333
12241.32,828,780,48,43,253,0.0667
12254.03,831,783,48,41,254,0.0667
12266.53,828,780,48,42,253,0.0667
12279.02,828,779,49,42,252,0.0667
12291.84,831,782,49,42,253,0.0667
12304.37,828,780,48,41,253,0.0667
12319.22,833,783,50,42,253,0.1
12332.08,828,780,48,42,253,0.1
12344.7,829,784,45,42,254,0.2
12357.8,830,782,48,42,254,0.2
12370.33,822,779,43,41,252,0.2333
12383.4,830,782,48,41,254,0.2333
12395.94,826,778,48,41,252,0.2333
12412.3,830,782,48,42,254,0.1667
12425.13,828,778,50,42,254,0.1667
12437.78,831,782,49,42,253,0.1333
12451.27,831,783,48,42,254,0.1333
12463.66,827,779,48,42,253,0.1
12476.75,831,783,48,42,253,0.0667
12489.34,828,780,48,42,253,0.1
12502.05,831,783,48,42,254,0.0667
12514.57,828,780,48,41,252,0.1
12527.08,828,779,49,41,252,0.0667
12540.0,831,782,49,42,253,0.0667
12552.55,830,779,51,42,253,0.1
12566.25,830,783,47,42,254,0.0667
12578.79,829,780,49,41,253,0.0667
12591.43,828,779,49,42,252,0.0667
12605.1,831,782,49,42,253,0.0667
12617.67,826,779,47,41,253,0.0333
12630.67,831,783,48,42,254,0.0
12643.21,828,780,48,41,252,-0.0333
12655.99,831,783,48,42,254,-0.0333
12668.5,831,783,48,42,254,-0.0333
12680.81,829,779,50,42,253,0.0
12694.1,830,783,47,41,254,0.0
12706.61,828,779,49,41,252,0.0333
12719.83,830,783,47,42,254,0.0333
12732.65,829,780,49,42,253,0.0
12745.28,828,779,49,42,252,0.0
12758.95,830,783,47,43,254,-0.0333
12771.99,826,779,47,42,253,0.0
12784.96,831,783,48,41,254,0.0
12797.53,828,780,48,42,253,0.0
12810.16,831,783,48,42,254,0.0
12822.67,830,782,48,42,254,0.0
12835.08,827,780,47,42,251,0.0
12848.04,831,782,49,41,254,0.0
12860.59,828,779,49,41,251,0.0
12873.34,831,782,49,43,254,0.0
12885.83,825,783,42,42,254,0.0
12898.13,829,779,50,41,252,0.0
12911.35,834,779,55,43,254,0.0
12923.85,827,779,48,42,252,0.0
12936.99,830,782,48,41,254,0.0
12949.74,828,780,48,42,253,0.0
12962.35,828,778,50,43,252,0.0
12975.93,831,783,48,43,253,0.0
12988.88,828,779,49,41,253,0.0
13001.8,832,777,55,43,254,0.0
13014.31,828,780,48,41,252,0.0
13026.92,832,783,49,42,254,0.0
13039.44,830,782,48,42,254,0.0
13051.83,829,779,50,41,253,0.0
13065.96,831,783,48,42,254,0.0
13078.54,827,780,47,42,253,0.0
13094.41,827,780,47,42,253,0.0
13107.68,825,777,48,42,252,0.0
13120.85,828,780,48,41,253,0.0
13134.13,829,780,49,42,253,0.0
13146.7,828,779,49,41,252,0.0
13159.73,828,780,48,42,253,0.0
13172.28,828,780,48,42,253,0.0
13184.88,828,780,48,42,252,0.0
13197.53,814,773,41,42,251,0.0
13210.13,821,781,40,42,253,0.0
13222.5,825,781,44,41,253,0.0
13234.28,821,777,44,41,252,0.0
13246.74,825,781,44,41,254,0.0
13258.58,825,781,44,41,252,0.0
13270.37,825,782,43,42,253,0.0
13282.32,825,781,44,42,253,0.0
13294.0,820,777,43,41,252,0.0
13306.16,824,781,43,42,253,0.0
13318.05,824,781,43,42,253,0.0
13329.72,820,777,43,42,252,0.0
13342.57,825,780,45,42,253,0.0
13354.39,820,777,43,43,251,0.0
13366.36,825,782,43,41,253,0.0
13378.24,826,782,44,41,253,0.0
13390.02,820,776,44,41,251,0.0
13402.3,824,781,43,42,253,0.0
13414.18,820,776,44,41,252,0.0
13426.1,825,782,43,42,253,0.0
13438.02,825,781,44,41,253,0.0
13449.84,820,778,42,42,252,0.0
13462.37,826,781,45,42,254,0.0
13474.21,825,780,45,42,252,0.0
13486.06,823,781,42,41,254,0.0
13498.09,825,781,44,41,253,0.0
13509.83,821,777,44,42,252,0.0
13522.44,825,780,45,41,252,0.0
13534.31,825,781,44,42,253,0.0
13546.05,820,775,45,42,251,0.0
13558.67,824,781,43,41,253,0.0
13570.71,821,778,43,42,252,0.0
13582.95,825,782,43,42,253,0.0
13594.83,825,782,43,41,253,0.0
13606.6,821,777,44,42,252,0.0
13619.66,825,781,44,42,253,0.0
13631.53,820,773,47,41,254,0.0
13643.48,825,781,44,41,253,0.0
13655.36,825,781,44,42,253,0.0
13667.22,820,783,37,42,249,0.0
13679.81,825,781,44,43,253,0.0
13691.68,821,776,45,41,252,0.0
13703.58,825,781,44,42,254,0.0
13715.48,824,780,44,42,252,0.0
13727.31,821,777,44,42,251,0.0
13739.67,825,784,41,42,254,-0.0333
13751.56,822,777,45,40,252,0.0
13763.53,824,779,45,42,253,0.0
13775.51,825,782,43,42,252,0.0
13787.68,820,776,44,41,251,0.0
13800.2,825,781,44,41,252,0.0
13812.08,821,777,44,41,252,0.0
13823.84,820,776,44,42,251,0.0
13836.77,825,780,45,42,253,0.0
13848.61,821,776,45,42,252,0.0
13860.88,826,780,46,42,253,0.0
13872.75,825,781,44,41,254,0.0
13884.53,823,777,46,42,251,0.0
13897.71,825,781,44,42,253,0.0
13909.58,827,780,47,42,252,0.0
13922.14,831,783,48,42,254,0.0
13934.97,831,783,48,42,253,0.0
13947.3,828,779,49,43,253,0.0
13960.14,828,782,46,41,254,0.0
13972.66,828,781,47,42,253,0.0
13985.23,831,783,48,42,253,0.0
13997.83,831,783,48,42,254,0.0
14010.24,828,779,49,43,253,0.0
14023.09,831,781,50,42,253,0.0
14035.59,829,779,50,41,253,0.0
14048.22,831,783,48,42,255,0.0
14060.7,833,783,50,41,254,0.0
14073.02,827,779,48,41,252,0.0
14086.03,830,783,47,42,254,0.0
14098.56,828,780,48,42,251,0.0
14111.27,829,783,46,42,254,0.0
14123.72,831,782,49,42,254,0.0
14136.11,832,780,52,42,253,0.0
14149.23,831,783,48,42,254,0.0
14161.73,828,779,49,41,252,0.0
14174.8,830,782,48,42,253,0.0
14187.33,828,780,48,43,253,0.0
14199.94,827,779,48,42,253,0.0
14213.34,832,783,49,41,253,0.0
14225.77,828,780,48,41,253,0.0
14239.03,831,782,49,43,254,0.0
14251.53,827,780,47,41,252,0.0
14264.12,832,783,49,41,253,0.0
14276.92,831,783,48,42,254,0.0
14289.27,827,780,47,42,253,0.0
14302.2,830,781,49,43,254,0.0
14314.71,823,779,44,41,251,0.0
14327.43,832,783,49,41,254,0.0
14339.91,832,783,49,43,254,0.0
14352.3,825,776,49,43,253,0.0
14365.18,831,782,49,42,254,0.0
14377.71,828,780,48,42,252,0.0
14390.34,831,783,48,42,253,0.0
14402.83,831,783,48,41,254,0.0
14415.35,828,779,49,42,252,0.0
14428.79,833,784,49,43,254,0.0
14441.25,824,775,49,42,251,0.0
14454.29,829,779,50,42,252,0.0
14466.93,829,779,50,42,253,0.0
14479.73,828,779,49,43,252,0.0
14493.05,830,783,47,41,254,0.0
14505.45,827,780,47,42,253,0.0
14518.76,828,782,46,42,253,0.0
14531.06,826,779,47,41,253,0.0
14543.48,830,783,47,42,253,0.0
14555.79,830,782,48,42,253,0.0
14568.03,827,779,48,41,252,0.0
14580.75,831,782,49,42,254,0.0
14593.06,827,779,48,42,252,0.0
14605.39,830,783,47,42,254,0.0
14617.82,829,782,47,43,254,0.0
14630.15,828,779,49,42,253,0.0
14643.16,831,783,48,42,254,0.0
14655.65,826,780,46,42,252,0.0
14668.28,832,781,51,42,254,0.0
14680.78,831,783,48,41,254,0.0
14693.16,831,780,51,43,251,0.0
14706.0,830,783,47,43,253,0.0
14718.52,828,780,48,42,252,-0.0333
14731.1,831,783,48,42,254,0.0
14743.59,831,783,48,40,253,0.0
14755.92,828,780,48,42,253,0.0
14768.87,831,782,49,42,254,0.0
14781.37,828,780,48,43,252,0.0
14794.02,831,783,48,43,254,0.0
14806.58,831,782,49,42,254,0.0
14819.01,827,776,51,42,254,0.0
14831.94,831,781,50,43,254,0.0
14844.45,827,779,48,42,253,0.0
14857.56,831,783,48,42,254,0.0
14870.05,828,780,48,42,251,0.0
14882.65,827,778,49,42,252,0.0
14896.19,831,783,48,41,253,0.0
14908.62,831,776,55,42,252,0.0
14921.86,831,783,48,42,253,0.0
14934.38,828,779,49,42,253,0.0
14946.96,831,782,49,42,254,0.0
14959.6,831,783,48,42,254,0.0
14971.93,828,779,49,43,253,0.0
14984.83,830,783,47,42,254,-0.0333
14997.41,829,780,49,42,253,0.0
15010.13,832,783,49,43,254,-0.0333
15022.61,831,783,48,42,254,0.0
15034.97,823,772,51,41,251,0.0
15048.32,831,783,48,42,254,0.0
15060.83,828,779,49,42,253,0.0
15073.74,832,783,49,42,254,0.0
15086.22,827,780,47,41,254,0.0
15098.61,829,780,49,42,253,0.0
15112.24,831,781,50,42,254,0.0
15124.69,823,779,44,42,251,0.0
15138.09,831,782,49,42,254,0.0
15150.6,829,780,49,42,253,0.0
15163.16,828,779,49,42,252,0.0
15176.72,830,782,48,41,253,0.0
15189.83,827,779,48,42,253,0.0
15202.69,831,782,49,42,254,0.0
15215.26,830,782,48,41,252,0.0
15228.05,831,783,48,43,254,0.0
15240.68,828,780,48,43,253,0.0
15254.62,828,778,50,41,252,0.0
15268.15,830,783,47,43,254,0.0
15280.7,831,782,49,42,252,0.0
15293.53,830,783,47,42,253,0.0
15306.05,831,777,54,42,253,0.0
15318.49,826,779,47,41,252,0.0
15331.85,832,783,49,43,253,0.0
15344.39,828,779,49,42,252,0.0
15357.34,831,783,48,42,254,0.0
15369.81,830,780,50,42,253,0.0
15382.21,829,780,49,42,252,0.0
15395.85,829,782,47,41,254,0.0
15408.35,829,780,49,43,252,0.0
15421.64,831,783,48,41,254,0.0
15434.15,828,779,49,42,253,0.0
15446.72,828,783,45,42,253,0.0
15459.75,832,783,49,43,253,0.0
15472.12,828,779,49,42,253,0.0
15485.23,836,783,53,42,252,0.0
15497.78,828,779,49,42,253,0.0
15510.37,830,783,47,42,254,0.0
15522.86,830,779,51,42,254,0.0
15535.28,830,778,52,42,253,0.0
15548.29,831,782,49,42,254,0.0
15560.8,826,780,46,42,253,0.0
15573.48,830,783,47,42,253,0.0
15585.96,830,783,47,42,254,0.0
15598.42,828,778,50,42,252,0.0
15611.67,830,789,41,41,254,0.0
15624.15,828,779,49,42,252,0.0
15637.41,831,782,49,42,254,0.0
15649.91,826,779,47,41,252,0.0
15662.49,828,779,49,41,252,0.0
15676.34,831,782,49,43,254,0.0
15688.86,828,780,48,42,253,0.0
15702.02,836,783,53,42,256,0.0
15714.52,828,780,48,43,253,0.0
15727.24,831,783,48,42,254,0.0
15740.05,830,783,47,42,254,0.0
15752.41,829,780,49,42,252,0.0
15765.68,829,782,47,42,253,0.0
15778.23,828,779,49,42,253,0.0
15791.26,829,790,39,41,254,0.0
15803.74,827,779,48,41,253,0.0
15816.33,828,779,49,42,253,0.0
15829.99,831,783,48,41,253,0.0
15842.49,825,776,49,41,252,0.0
15855.94,830,782,48,41,254,0.0
15868.5,828,779,49,42,253,0.0
15881.07,832,781,51,42,254,0.0333
15893.59,832,782,50,46,254,5.9
15905.93,828,780,48,60,252,16.6667
15918.83,831,783,48,65,253,19.7
15931.42,828,778,50,74,251,22.0
15948.78,831,782,49,81,254,25.2
15961.25,829,779,50,87,253,27.1
15973.64,830,783,47,91,254,27.8667
15986.38,831,782,49,89,253,28.6
15999.01,829,780,49,93,253,28.9333
16013.13,831,783,48,92,254,29.7
16027.25,829,780,49,98,253,29.5333
16039.86,829,782,47,95,253,29.5
16052.15,829,782,47,96,253,29.8667
16064.24,829,781,48,93,254,29.4667
16076.74,831,782,49,94,254,29.1667
16089.04,826,780,46,94,252,29.4667
16101.45,830,782,48,94,254,29.7667
16113.75,831,782,49,95,254,29.8333
16125.94,830,783,47,98,253,29.5333
16138.47,831,779,52,96,254,29.6333
16150.88,828,775,53,96,253,29.7333
16163.46,831,782,49,96,254,29.6333
16175.95,831,783,48,95,254,29.4333
16188.31,830,784,46,96,254,29.4333
16201.06,831,783,48,96,253,29.5333
16213.56,828,779,49,95,253,29.7
16226.15,832,783,49,95,254,29.2667
16238.67,831,783,48,94,254,29.4667
16255.83,829,782,47,95,254,29.8333
16268.92,829,780,49,98,253,29.6667
16281.63,826,777,49,94,251,29.7333
16294.82,827,779,48,94,252,29.7333
16307.6,825,777,48,96,252,29.2
16321.0,829,780,49,96,253,29.5667
16333.59,824,778,46,96,252,29.5667
16346.72,821,777,44,94,252,29.6667
16358.69,822,778,44,95,252,29.5667
16370.89,821,776,45,94,252,30.0
16384.02,825,781,44,95,253,29.7
16395.92,826,778,48,94,252,29.5333
16407.85,826,782,44,97,254,29.7667
16419.87,826,781,45,97,254,29.7
16431.88,820,777,43,95,252,30.1667
16444.6,824,781,43,97,253,29.9667
16456.49,825,781,44,96,254,29.8667
16468.32,820,776,44,95,251,29.7333
16481.18,825,781,44,95,253,29.9667
16492.99,819,772,47,94,253,29.8667
16505.29,825,781,44,96,253,29.9
16517.16,825,781,44,96,253,29.8
16528.98,817,777,40,95,252,29.9
16541.19,825,781,44,94,253,29.5333
16553.08,821,777,44,98,251,30.1667
16565.27,825,779,46,95,252,29.7
16577.19,824,781,43,96,253,29.5
16589.01,820,776,44,97,252,30.0667
16601.33,831,780,51,97,253,29.4333
16613.21,822,780,42,93,252,30.6667
16625.08,825,781,44,93,253,29.6667
16637.18,824,781,43,96,254,29.4667
16649.21,821,777,44,96,252,29.9
16661.88,824,781,43,94,253,29.7
16673.74,825,781,44,97,251,30.0333
16685.57,822,776,46,97,252,30.0333
16698.73,825,781,44,97,253,30.0667
16710.53,821,777,44,96,252,30.2333
16722.83,825,781,44,96,253,29.7667
16734.72,824,782,42,96,253,29.6333
16746.47,828,777,51,96,252,29.8
16759.42,825,780,45,96,254,29.8667
16771.31,820,776,44,97,252,29.8333
16783.42,824,780,44,98,253,29.7667
16795.31,825,781,44,94,253,30.0333
16807.09,821,777,44,96,252,29.9333
16819.42,824,780,44,97,254,30.0
16831.3,820,777,43,96,252,30.3
16843.26,825,782,43,97,253,30.5667
16855.16,824,778,46,99,253,29.8
16867.05,820,778,42,98,251,30.0667
16879.72,825,781,44,98,253,29.9667
16891.58,823,780,43,95,251,30.0667
16903.44,823,781,42,98,253,29.7667
16915.64,825,782,43,95,253,30.2333
16927.41,821,778,43,96,252,30.2
16940.07,825,781,44,97,253,30.1
16951.95,824,781,43,95,253,29.8667
16963.71,820,776,44,98,251,30.0
16976.53,825,782,43,94,253,30.0333
16988.34,819,776,43,96,251,30.3
17000.9,825,781,44,98,253,29.9333
17012.79,825,781,44,98,254,30.8333
17024.58,821,777,44,100,252,29.9667
17037.69,824,780,44,99,253,30.4667
17049.83,828,779,49,98,253,29.7333
17062.46,831,782,49,98,254,29.8667
17075.28,831,783,48,99,253,30.0667
17087.72,822,780,42,96,253,30.2
17101.14,831,782,49,98,254,30.2333
17113.66,828,780,48,95,252,30.1
17126.39,831,783,48,96,254,29.8333
17138.99,831,783,48,96,254,29.8667
17151.37,828,778,50,93,252,29.9333
17164.41,831,782,49,94,254,28.7667
17176.9,827,780,47,93,252,29.3
17189.81,829,782,47,94,254,29.3
17202.25,829,779,50,93,253,28.9
17214.72,828,779,49,92,253,28.6667
17227.82,831,783,48,91,254,28.6667
17240.35,828,780,48,93,253,28.6333
17253.73,831,783,48,89,254,28.1
17266.26,823,778,45,90,251,27.7333
17279.3,825,781,44,89,253,27.8
17292.62,832,782,50,88,254,27.8667
17305.25,825,778,47,88,253,27.1667
17318.32,832,782,50,86,254,27.3667
17330.85,828,780,48,83,252,27.2
17343.53,830,783,47,86,253,26.8667
17356.03,831,783,48,85,254,26.5333
17368.44,830,780,50,83,253,26.3333
17381.6,831,783,48,84,254,26.0333
17394.12,828,778,50,80,253,26.3
17407.11,831,783,48,81,253,25.7333
17419.65,829,776,53,77,252,25.6333
17432.27,828,779,49,80,253,25.2333
17445.89,831,783,48,78,254,25.0667
17458.39,828,780,48,78,252,24.8667
17471.55,831,783,48,78,254,24.8
17484.08,828,779,49,78,253,24.7333
17496.71,831,783,48,76,254,24.8667
17509.19,831,782,49,80,255,24.6333
17521.59,828,780,48,77,253,24.7333
17534.51,831,783,48,77,254,24.7333
17547.01,828,779,49,78,253,24.7333
17559.6,832,783,49,76,254,24.6
17572.16,831,783,48,78,253,24.9
17584.57,828,779,49,75,252,24.4
17597.52,832,783,49,75,254,24.0667
17610.05,829,780,49,75,253,24.1667
17622.71,831,783,48,75,253,24.1667
17635.2,830,783,47,78,254,24.4333
17647.52,828,780,48,75,253,24.4
17660.67,831,783,48,78,253,24.6333
17673.16,828,779,49,75,253,23.8
17686.27,831,783,48,76,253,23.9
17698.77,827,784,43,76,253,24.3
17711.32,828,779,49,75,253,24.5
17724.94,831,782,49,75,254,23.9
17737.63,828,780,48,76,253,24.4667
17750.79,831,782,49,76,254,24.4
17763.31,828,780,48,77,253,23.9667
17775.97,833,783,50,76,254,24.5333
17788.48,832,783,49,73,254,23.7667
17800.9,827,780,47,74,252,24.0333
17813.82,831,783,48,77,254,23.7667
17826.32,827,779,48,74,253,24.0667
17838.9,831,783,48,75,254,23.9667
17851.41,832,783,49,75,254,23.9
17863.83,827,779,48,74,253,23.3667
17876.73,829,783,46,70,254,22.7333
17889.25,827,778,49,71,252,22.8
17902.29,831,783,48,71,254,22.7
17915.03,831,779,52,70,252,22.4667
17927.56,828,779,49,70,253,22.4333
17941.29,830,781,49,70,254,21.9667
17953.78,826,779,47,68,253,22.0
17967.24,830,783,47,70,254,22.0667
17979.75,828,779,49,69,253,21.5667
17992.41,828,778,50,70,253,21.8333
18005.54,825,784,41,67,252,21.5667
18017.96,828,779,49,68,253,21.3333
18031.09,831,783,48,68,254,21.6
18043.6,828,780,48,67,253,21.2667
18056.21,830,782,48,67,253,21.5
18068.74,830,783,47,67,253,20.9
18081.06,827,780,47,69,253,20.9667
18093.91,831,783,48,66,254,20.9
18106.42,828,780,48,66,253,20.9
18119.05,832,783,49,67,254,20.7333
18131.54,831,789,42,64,253,20.4
18143.99,828,780,48,64,253,20.5
18156.82,831,782,49,67,254,20.1
18169.35,828,780,48,64,253,20.3333
18182.0,831,783,48,66,254,19.9667
18194.49,831,783,48,66,254,20.1333
18206.81,828,779,49,64,253,19.9667
18219.74,831,781,50,64,253,20.0
18232.29,829,780,49,64,253,20.0
18245.02,832,782,50,63,254,19.7667
18257.64,832,779,53,65,254,19.7333
18270.0,826,778,48,64,253,19.8667
18283.16,831,783,48,64,253,19.8333
18295.7,828,779,49,63,253,19.6667
18308.91,831,783,48,63,254,19.5333
18321.44,827,780,47,64,253,19.2667
18334.05,828,777,51,64,252,19.3
18347.69,832,783,49,63,254,19.2
18360.2,828,780,48,62,253,19.2667
18373.41,831,781,50,62,253,19.0333
18385.92,827,779,48,60,253,18.9
18398.52,831,783,48,61,254,19.0667
18411.03,831,782,49,63,254,19.0667
18423.48,828,780,48,62,253,18.6667
18436.51,831,783,48,60,255,18.7
18449.1,828,780,48,61,253,18.6333
18461.82,831,783,48,60,254,18.6333
18474.28,832,783,49,60,254,18.4
18486.64,829,777,52,61,252,18.1
18500.07,831,783,48,60,254,17.9
18512.6,828,779,49,60,253,18.1333
18525.74,831,783,48,60,254,18.0333
18538.28,829,780,49,59,253,17.7333
18550.87,829,779,50,61,253,17.7667
18564.55,831,782,49,58,254,17.6333
18577.04,826,777,49,57,251,17.4667
18590.53,831,783,48,59,254,17.4333
18603.05,827,779,48,58,253,17.2
18615.65,828,783,45,58,254,17.3
18628.24,831,783,48,58,254,17.2333
18640.77,828,780,48,58,253,17.1667
18653.7,826,784,42,57,254,16.8333
18666.23,828,779,49,57,253,16.8
18679.33,830,783,47,57,253,16.7667
18691.6,824,778,46,56,253,16.6333
18703.95,825,778,47,55,252,16.6
18717.46,831,783,48,56,253,16.2333
18729.7,828,779,49,56,253,16.2333
18742.81,829,777,52,55,254,16.1
18755.1,827,779,48,55,253,15.8667
18767.54,823,777,46,55,253,15.7667
18780.54,832,782,50,54,254,15.7333
18792.94,828,779,49,55,253,15.5
18806.39,831,782,49,54,253,15.4667
18818.89,828,780,48,54,253,15.2333
18831.52,832,783,49,55,254,15.1333
18844.34,831,783,48,54,254,15.0667
18856.72,828,779,49,54,252,15.0667
18869.64,831,789,42,53,254,14.9
18882.2,828,780,48,53,253,14.9667
18894.84,832,783,49,53,254,14.7667
18907.36,831,783,48,52,254,14.5
18919.77,829,779,50,53,253,14.3667
18932.75,832,783,49,52,253,14.2333
18945.25,829,781,48,52,253,14.0333
18957.92,831,783,48,53,254,13.9667
18970.4,830,782,48,50,254,14.0
18982.78,828,780,48,51,252,13.9667
18996.15,831,783,48,53,255,13.9
19008.64,827,776,51,52,253,14.0333
19021.64,831,782,49,51,254,13.8
19034.15,827,779,48,51,253,13.9
19046.7,827,778,49,52,252,13.9667
19060.32,831,783,48,52,254,14.0
19072.79,828,780,48,52,252,13.7333
19085.95,831,782,49,52,254,13.7333
19098.47,828,779,49,52,253,13.8
19111.06,831,783,48,52,254,13.8333
19123.53,831,783,48,52,254,13.8667
19135.99,828,779,49,51,252,13.8
19148.88,831,782,49,50,254,13.7
19161.41,828,779,49,52,253,13.8
19173.99,831,783,48,52,254,13.9667
19186.52,831,783,48,52,254,14.0333
19199.82,828,780,48,53,253,14.1667
19212.58,831,788,43,53,254,14.4333
19227.63,826,778,48,54,252,14.6333
19241.31,829,780,49,53,253,14.9
19254.06,825,775,50,53,252,15.0333
19270.63,826,777,49,53,252,15.0333
19283.34,831,778,53,53,252,15.2667
19295.99,815,777,38,53,252,15.2333
19307.9,821,777,44,54,252,15.1333
19319.94,819,778,41,55,252,15.3667
19333.07,824,782,42,54,254,15.4
19345.0,824,780,44,55,252,15.6
19356.86,825,775,50,55,254,15.9
19368.97,824,782,42,55,253,16.0333
19380.66,822,778,44,54,252,15.9667
19392.74,820,777,43,55,251,16.0667
19405.68,825,781,44,55,253,16.2333
19417.49,820,775,45,56,252,16.4667
19429.72,824,781,43,57,253,16.6333
19441.57,825,781,44,55,253,16.6
19453.34,819,775,44,56,252,16.8667
19466.38,825,781,44,57,253,16.8667
19478.24,821,777,44,56,252,17.1667
19490.15,824,781,43,58,253,17.3333
19502.02,825,781,44,58,254,17.3
19513.73,821,777,44,59,252,17.4667
19526.09,825,781,44,57,253,17.4
19537.99,820,776,44,57,252,17.4667
19549.91,825,781,44,59,253,17.8
19561.79,825,782,43,59,253,17.9667
19573.61,821,778,43,60,252,18.0333
19586.2,823,779,44,60,253,18.2
19598.11,825,780,45,60,252,18.2667
19609.98,825,781,44,61,252,18.4667
19622.19,825,781,44,62,254,18.3333
19633.96,822,777,45,60,251,18.6
19646.65,825,781,44,62,253,18.6667
19658.54,825,781,44,61,253,19.0
19670.33,821,776,45,60,251,19.3
19683.29,825,781,44,61,253,19.0333
19695.09,822,778,44,61,252,19.3333
19707.09,824,782,42,61,253,19.2667
19719.02,825,781,44,62,254,19.2
19730.74,818,777,41,62,252,19.3
19743.97,824,782,42,61,253,19.3333
19755.84,821,776,45,62,252,19.7
19767.88,825,781,44,63,253,19.5667
19779.79,825,781,44,63,253,19.9333
19791.55,819,777,42,62,252,19.8667
19803.84,825,781,44,64,253,19.7667
19815.76,819,776,43,63,252,19.8333
19827.73,825,781,44,64,253,19.8667
19839.63,824,781,43,66,253,19.8667
19851.44,820,777,43,64,252,19.9667
19864.06,825,781,44,65,253,19.9
19875.95,824,781,43,63,251,19.9333
19887.77,825,781,44,63,253,20.0667
19899.9,824,781,43,64,254,19.8333
19911.62,821,777,44,65,253,20.1
19924.32,825,782,43,66,254,20.0
19936.22,826,781,45,64,253,19.8333
19950.43,820,775,45,64,251,20.2
19962.87,825,781,44,65,253,20.2667
19974.66,819,778,41,66,252,20.9
19987.22,826,781,45,66,253,20.5667
19999.11,828,780,48,66,253,20.6667
20011.55,827,780,47,65,252,20.6667
20025.18,829,783,46,66,254,20.5667
20037.76,828,779,49,68,253,20.3667
20051.01,830,783,47,66,254,20.5
20063.52,828,780,48,68,253,20.7333
20076.14,829,778,51,67,254,20.7667
20089.07,831,782,49,65,254,20.8
20101.48,828,779,49,66,253,20.8333
20114.46,831,783,48,68,253,20.9667
20126.97,827,779,48,70,253,21.5667
20139.65,831,783,48,70,255,21.7667
20152.16,831,783,48,71,254,22.2
20164.49,828,779,49,72,252,22.6333
20177.71,831,783,48,72,254,22.7
20190.18,827,779,48,72,253,22.9
20203.18,831,783,48,74,252,23.0333
20215.72,827,780,47,71,253,23.3333
20228.39,827,778,49,74,252,23.8333
20242.05,830,782,48,75,254,24.0667
20254.55,829,780,49,76,253,23.9333
20267.78,831,782,49,76,254,24.4333
20280.29,829,780,49,77,252,24.3333
20292.99,829,783,46,78,254,25.0667
20305.53,830,783,47,80,253,25.2
20317.96,827,780,47,83,253,25.1333
20331.11,832,783,49,83,254,26.2333
20343.62,828,779,49,83,252,27.0333
20356.67,831,783,48,87,254,27.3333
20369.19,828,780,48,86,253,27.4667
20381.77,829,779,50,88,253,27.8667
20395.38,831,783,48,89,254,27.9333
20407.89,828,779,49,88,252,27.7667
20421.15,831,783,48,90,254,28.2333
20433.68,827,779,48,89,252,28.3667
20446.35,831,782,49,92,254,28.5667
20458.93,831,783,48,88,254,28.0
20471.29,831,780,51,92,252,28.1
20484.57,833,783,50,89,254,27.5667
20497.08,828,779,49,89,253,27.9667
20510.08,831,783,48,89,254,28.3333
20522.57,828,780,48,90,253,27.9
20534.99,828,778,50,89,253,28.2667
20548.79,831,783,48,89,253,28.3
20561.36,831,780,51,90,252,28.0667
20574.6,831,783,48,89,253,28.0667
20587.11,825,780,45,89,253,27.8667
20599.93,833,783,50,90,254,27.9667
20612.82,831,783,48,89,254,28.7333
20625.12,827,780,47,90,252,28.6
20638.1,828,780,48,91,253,28.3333
20650.75,828,779,49,92,253,29.0333
20663.43,831,781,50,91,253,29.4
20675.95,829,782,47,96,254,29.5667
20688.33,827,779,48,98,253,30.0
20701.47,831,782,49,102,254,30.8
20713.99,828,779,49,104,253,31.5333
20727.04,832,783,49,106,254,31.8667
20739.58,828,780,48,110,253,32.1667
20752.22,828,777,51,109,252,32.4
20765.85,831,783,48,110,254,32.3333
20778.38,831,780,51,108,253,32.5
20791.43,830,783,47,109,255,32.9
20804.04,825,777,48,111,253,33.1
20816.68,833,782,51,110,254,32.8
20829.18,831,783,48,106,254,32.9667
20841.64,828,780,48,110,253,33.3
20854.56,830,782,48,111,254,32.9667
20867.07,829,779,50,106,253,32.4
20879.86,830,783,47,109,254,32.9
20892.32,832,783,49,111,254,33.3333
20904.74,828,780,48,111,253,32.7
20918.11,831,783,48,109,254,32.7667
20930.63,828,779,49,109,252,32.5333
20943.64,831,783,48,110,254,32.6
20956.14,828,779,49,108,253,32.6333
20968.72,828,778,50,110,252,33.1
20982.54,831,782,49,113,254,32.7333
20995.04,829,780,49,110,253,32.6
21008.21,831,783,48,109,254,32.7667
21020.71,827,779,48,111,253,32.6667
21033.33,829,783,46,110,254,33.0667
21045.82,831,782,49,109,254,32.8667
21058.21,829,779,50,108,253,32.9
21071.13,830,782,48,110,254,32.1667
21083.65,829,776,53,112,254,33.0
21096.33,831,783,48,112,253,32.9
21108.89,830,783,47,112,253,32.5667
21121.26,829,780,49,112,252,33.2333
21134.34,831,782,49,111,253,33.8667
21146.85,827,779,48,109,253,32.7667
21159.96,831,782,49,108,253,32.6
21172.49,828,780,48,113,253,32.9333
21185.12,827,779,48,110,253,33.3333
21198.9,831,782,49,111,253,32.8333
21211.44,828,778,50,110,253,33.1667
21224.63,831,783,48,107,254,32.7
21237.73,825,778,47,111,252,33.0
21255.22,831,783,48,108,254,32.6
21267.82,829,779,50,108,253,32.8
21280.46,831,783,48,112,254,33.2
21293.06,832,783,49,109,254,32.9333
21305.44,827,779,48,110,253,32.2667
21318.7,831,781,50,107,254,32.5667
21331.29,829,779,50,110,253,32.8667
21344.1,832,783,49,107,254,32.8333
21356.65,831,782,49,114,254,32.3
21369.1,828,779,49,108,253,33.2
21382.93,831,782,49,109,253,32.5667
21395.5,827,779,48,109,253,32.2667
21408.86,831,782,49,111,253,32.9667
21421.62,826,779,47,111,253,32.4667
21434.31,827,780,47,109,254,33.0667
21447.5,830,780,50,106,253,32.5667
21460.03,826,779,47,109,253,32.9333
21472.97,829,782,47,112,254,32.7667
21485.51,826,778,48,108,252,33.2333
21498.23,831,782,49,109,254,32.7333
21510.77,829,780,49,110,254,33.3333
21523.16,827,778,49,111,253,32.9
21536.01,831,782,49,111,254,33.1667
21548.56,827,777,50,109,252,32.9
21561.59,830,782,48,105,254,33.5
21574.11,826,778,48,112,253,33.1667
21586.77,826,779,47,107,252,33.7667
21600.83,832,782,50,107,253,33.3333
21613.29,827,779,48,108,253,32.6667
21626.43,830,781,49,109,254,32.9
21639.04,827,779,48,107,252,32.8667
21651.75,831,782,49,107,254,32.8333
21664.33,830,782,48,110,253,33.6
21676.8,827,779,48,108,253,32.7333
21689.62,830,782,48,109,253,33.2333
21702.17,826,778,48,111,252,32.7
21715.22,830,782,48,107,253,33.0333
21727.82,827,778,49,112,252,32.8333
21740.38,828,777,51,106,252,32.9333
21753.94,831,782,49,110,255,33.5
21766.78,828,784,44,109,252,33.0
21780.11,828,780,48,110,253,32.9667
21792.68,827,779,48,108,253,32.9667
21805.39,829,782,47,111,253,32.9333
21818.41,831,781,50,107,253,32.6667
21830.75,827,778,49,111,252,33.0333
21843.96,830,782,48,108,254,32.3667
21856.51,821,778,43,110,251,33.1
21869.65,831,781,50,110,254,33.0
21882.49,827,779,48,110,253,33.5667
21895.15,826,777,49,106,252,32.6667
21908.92,832,782,50,108,254,32.5
21921.45,827,779,48,107,253,32.4667
21934.97,831,783,48,106,253,32.1
21947.58,827,777,50,104,254,32.0667
21960.29,831,782,49,107,254,31.4333
21972.85,829,782,47,104,254,31.3
21985.25,827,779,48,102,253,31.4333
21998.41,830,782,48,104,254,31.2
22011.16,828,779,49,102,252,31.0667
22024.37,830,782,48,100,253,30.6
22036.9,828,776,52,99,253,30.5333
22049.76,827,777,50,98,252,30.1667
22063.4,830,782,48,98,253,29.8333
22075.96,828,779,49,94,252,29.2333
22089.22,830,782,48,93,253,29.3333
22101.76,828,778,50,96,253,29.9667
22114.48,831,782,49,93,254,29.3667
22127.56,831,777,54,97,254,29.4667
22140.17,825,776,49,91,251,29.2667
22153.23,827,779,48,91,253,29.3333
22166.34,824,776,48,92,251,28.8
22179.83,825,776,49,91,251,28.0333
22192.85,824,776,48,89,252,28.7333
22206.19,826,779,47,90,253,28.4667
22219.23,820,776,44,89,252,28.3
22231.17,820,776,44,87,252,28.4667
22243.28,820,776,44,88,252,28.0667
22256.33,818,776,42,87,252,27.8667
22268.3,825,779,46,89,252,28.4667
22280.19,824,780,44,86,253,27.5333
22292.03,819,776,43,87,251,27.4667
22304.44,824,780,44,87,254,27.6
22316.39,817,775,42,86,251,27.9333
22328.4,823,780,43,87,253,27.7
22340.4,826,780,46,86,250,27.4
22352.27,818,775,43,87,251,27.2
22365.15,823,781,42,88,253,27.8333
22377.06,823,776,47,81,251,26.9333
22388.96,823,780,43,85,253,27.0667
22401.05,821,780,41,85,252,26.8
22412.77,819,776,43,86,252,26.4
22425.4,822,779,43,84,252,26.5
22437.36,824,777,47,85,252,26.9333
22449.41,820,776,44,84,251,26.3333
22461.72,824,780,44,82,253,26.5333
22473.5,818,775,43,80,250,26.4
22485.82,823,780,43,82,253,26.2667
22497.76,824,778,46,83,253,26.1333
22509.56,819,774,45,80,252,26.4667
22522.53,823,780,43,80,253,25.5333
22534.44,820,775,45,79,252,25.9333
22546.45,824,780,44,80,253,25.9
22558.34,824,780,44,81,253,25.7333
22570.16,820,776,44,80,251,25.7333
22583.55,825,780,45,80,253,25.4667
22595.46,824,776,48,77,252,25.2
22607.39,823,781,42,79,253,25.6667
22619.29,825,780,45,80,253,25.2
22631.12,820,776,44,79,253,25.4333
22643.5,825,780,45,79,253,25.3333
22655.4,824,776,48,77,251,25.5
22667.29,824,775,49,80,252,25.7
22679.28,825,781,44,79,253,25.2
22691.54,820,774,46,79,252,25.2333
22704.34,823,776,47,76,252,25.4667
22716.21,824,780,44,78,253,25.0333
22728.03,821,777,44,79,252,24.9
22740.57,824,780,44,77,253,24.7333
22752.33,820,775,45,77,251,24.8
22764.89,825,780,45,79,253,25.0333
22776.72,828,780,48,78,253,24.7
22788.48,820,776,44,77,251,24.7
22801.34,824,781,43,78,253,24.7667
22813.09,813,775,38,76,251,24.7333
22825.22,824,780,44,77,253,24.7
22837.06,825,781,44,77,253,24.8
22848.76,820,776,44,76,251,24.6
22861.69,824,780,44,77,252,24.7667
22873.51,819,776,43,78,252,24.8333
22885.49,825,780,45,79,253,24.5
22897.42,824,781,43,76,253,24.7
22909.25,819,776,43,75,252,24.4667
22921.49,823,780,43,78,253,24.6333
22933.48,826,778,48,77,252,24.6667
22946.04,827,778,49,77,252,24.2
22959.92,830,782,48,78,254,24.4333
22972.4,825,779,46,76,252,24.4667
22985.47,830,782,48,77,253,24.2333
22998.04,827,779,48,74,253,23.8333
23010.67,830,784,46,73,253,23.5667
23023.21,830,782,48,72,254,23.4667
23035.62,827,778,49,75,253,23.0
23048.6,831,782,49,75,253,23.1
23061.12,827,780,47,71,252,23.0333
23073.77,830,782,48,71,253,23.3667
23086.26,830,782,48,69,254,22.7
23098.57,823,784,39,71,253,22.5667
23111.71,831,783,48,72,253,22.5333
23124.32,831,781,50,71,253,22.6667
23137.19,831,782,49,71,254,22.6
23149.73,830,781,49,72,254,22.0667
23162.16,827,777,50,69,252,22.5333
23175.4,829,780,49,71,253,22.2333
23187.97,830,782,48,69,253,21.8667
23200.7,832,782,50,70,253,21.7
23213.22,830,781,49,69,254,21.7
23225.75,821,777,44,69,250,21.4
23239.15,831,782,49,68,254,21.6333
23251.72,827,778,49,67,252,21.4
23265.12,831,782,49,68,253,21.0333
23277.73,830,781,49,67,253,21.0667
23290.31,826,779,47,65,253,20.5667
23303.92,830,780,50,65,253,20.2333
23316.55,826,779,47,66,252,20.0
23329.53,830,780,50,63,253,20.0
23342.04,830,782,48,63,253,19.5667
23354.74,831,782,49,64,254,19.3667
23367.55,828,782,46,62,253,19.2667
23379.96,827,776,51,64,252,19.3667
23392.91,830,781,49,61,253,19.2
23405.47,830,779,51,62,254,18.9667
23418.24,830,782,48,62,254,18.6333
23430.77,830,781,49,61,253,18.2
23443.27,828,777,51,60,252,18.2
23456.52,831,782,49,59,254,17.6667
23469.13,831,782,49,61,253,17.8667
23481.84,831,782,49,59,253,17.8333
23494.37,830,783,47,59,254,17.8667
23506.83,828,780,48,59,253,17.8667
23520.07,828,779,49,59,254,17.6667
23532.65,832,782,50,59,254,17.5333
23545.4,831,783,48,58,254,17.5667
23557.94,830,782,48,59,253,17.5333
23570.4,828,780,48,57,252,17.2667
23583.63,832,782,50,58,254,17.0667
23596.21,831,782,49,57,253,16.9
23608.89,831,783,48,57,254,16.7667
23621.41,832,779,53,57,254,16.8
23633.86,829,778,51,57,252,16.6
23647.11,830,783,47,56,254,16.4
23659.75,831,782,49,57,254,16.3333
23672.47,831,783,48,57,253,16.2333
23685.18,830,782,48,56,254,16.2
23697.61,829,779,50,54,252,16.2333
23710.88,831,783,48,55,254,16.0
23723.42,831,782,49,57,253,15.7333
23736.17,831,783,48,55,254,15.8333
23748.69,832,779,53,55,254,15.8
23761.16,828,779,49,55,252,15.7333
23774.34,831,783,48,54,253,15.3667
23786.89,831,782,49,54,253,15.5
23799.61,829,783,46,54,254,15.4
23812.15,832,782,50,56,253,15.4333
23824.56,827,780,47,54,253,15.4333
23837.67,829,783,46,54,254,15.4333
23850.22,830,782,48,55,254,15.4
23862.97,832,783,49,55,254,15.3667
23875.45,832,782,50,54,254,15.3667
23887.88,827,779,48,54,252,15.1667
23901.1,831,782,49,53,254,15.0667
23913.66,831,782,49,54,253,14.9
23926.36,831,783,48,54,254,14.7667
23938.89,830,782,48,53,254,14.8
23951.37,828,779,49,53,252,14.8333
23964.64,827,783,44,53,253,14.8667
23977.26,831,782,49,52,254,14.7
23989.95,831,782,49,53,254,14.4333
24002.41,829,780,49,53,253,14.6
24014.73,831,782,49,54,254,14.4333
24027.49,831,783,48,52,254,14.4
24040.0,831,782,49,53,254,14.2667
24052.8,832,783,49,53,256,14.2
24065.33,828,780,48,51,253,14.2333
24078.07,832,782,50,53,254,14.2333
24090.98,832,783,49,52,254,14.1
24103.53,830,780,50,52,252,14.1667
24116.42,831,783,48,53,254,14.2667
24128.99,828,780,48,52,252,14.2667
24141.56,824,779,45,53,252,14.2333
24154.19,826,778,48,52,253,14.2
24166.15,825,781,44,53,253,14.3
24178.19,825,781,44,52,253,14.1333
24190.03,819,776,43,52,251,14.1
24201.94,825,782,43,52,253,14.2333
24213.79,825,782,43,52,253,14.1
24225.55,825,780,45,53,253,14.3667
24237.77,825,781,44,53,253,14.2
24249.64,826,781,45,51,253,14.1667
24261.35,824,780,44,54,253,14.2
24273.42,824,781,43,51,254,14.0667
24285.24,822,778,44,51,252,14.0667
24297.42,825,781,44,52,253,14.1333
24309.67,825,781,44,51,253,14.1333
24321.78,821,776,45,52,252,14.0333
24334.94,826,781,45,51,253,14.0
24347.21,821,777,44,52,252,14.2333
24359.18,820,782,38,51,253,14.2
24371.04,821,778,43,53,253,14.1667
24382.78,823,780,43,51,253,14.1667
24394.82,826,781,45,52,253,14.0
24406.66,821,775,46,52,251,14.1333
24418.57,827,781,46,52,253,14.0667
24430.43,825,781,44,52,253,14.0333
24442.2,825,780,45,51,253,14.0
24454.37,826,781,45,52,253,13.9667
24466.23,824,781,43,52,253,14.1667
24477.99,824,780,44,53,252,14.1
24490.04,825,781,44,52,253,14.0667
24501.86,821,780,41,53,253,13.9667
24513.92,824,781,43,51,253,14.0333
24525.76,825,782,43,51,253,13.9333
24537.55,822,781,41,52,253,13.8333
24549.67,824,782,42,51,253,13.7667
24561.54,818,776,42,52,252,13.4667
24573.43,825,781,44,50,254,13.2667
24585.3,825,782,43,50,253,13.2667
24596.97,825,781,44,50,253,13.0667
24609.1,826,781,45,51,253,13.0333
24620.94,824,781,43,50,252,13.0333
24632.65,825,780,45,51,253,13.0333
24644.72,826,781,45,50,253,12.9333
24656.54,822,778,44,51,253,12.7667
24668.6,824,781,43,49,253,12.7667
24680.46,825,781,44,49,253,12.6333
24692.26,823,781,42,48,253,12.6333
24704.34,825,781,44,51,253,12.4
24716.23,820,776,44,48,252,12.3667
24728.11,826,781,45,48,253,12.2667
24739.99,821,777,44,48,252,12.1667
24752.07,823,781,42,49,252,12.1
24764.16,826,781,45,50,252,11.9
24776.01,823,781,42,46,252,11.7667
24787.81,825,780,45,48,253,11.6
24799.86,824,781,43,48,254,11.5
24811.6,824,780,44,48,253,11.3667
24823.74,825,782,43,47,253,11.0333
24835.59,826,781,45,47,253,10.8
24847.3,830,782,48,48,253,10.6333
24859.97,831,783,48,47,254,10.5
24872.44,828,780,48,48,253,10.5667
24885.04,831,783,48,47,253,10.4
24897.61,831,782,49,47,254,10.3667
24909.94,831,782,49,48,254,10.4333
24922.7,831,783,48,48,254,10.3
24935.17,827,780,47,47,251,10.2667
24947.76,830,783,47,47,253,10.2
24960.13,830,783,47,46,254,10.3
24972.25,824,782,42,47,252,10.3333
24984.76,829,782,47,45,253,10.2667
24997.06,827,779,48,48,253,10.2333
25009.43,831,783,48,47,254,10.2
25022.01,830,782,48,47,253,10.1333
25034.41,825,777,48,47,252,10.1667
25051.86,827,780,47,46,252,10.1667
25065.27,825,777,48,49,252,10.1333
25078.8,829,780,49,47,255,10.0667
25092.56,829,781,48,47,253,10.1333
25105.33,827,779,48,46,252,9.9667
25119.06,828,779,49,46,252,10.1
25131.73,828,780,48,47,253,10.1333
25144.4,828,780,48,47,253,10.1
25157.56,822,777,45,46,252,10.1
25169.84,831,776,55,47,253,10.3
25181.75,825,780,45,48,254,10.4
25193.73,825,782,43,47,253,10.5333
25205.66,824,782,42,47,253,10.7667
25217.49,821,777,44,47,252,10.9667
25229.82,825,781,44,48,253,11.0333
25241.69,832,782,50,48,255,11.1667
25253.62,825,778,47,48,252,11.4667
25265.9,825,781,44,49,252,11.6667
25277.67,821,777,44,48,250,11.7667
25290.26,825,781,44,48,253,11.8333
25302.17,824,780,44,49,254,12.1
25313.96,823,776,47,50,252,12.2333
25326.85,825,781,44,49,253,12.3
25338.69,824,780,44,49,253,12.5333
25350.69,824,782,42,49,251,12.3667
25362.6,826,782,44,50,253,12.5
25374.38,821,777,44,50,252,12.6667
25387.34,824,781,43,51,253,12.7667
25399.25,820,776,44,49,252,12.6
25411.2,825,782,43,49,254,12.6
25423.08,821,772,49,49,255,12.5
25434.87,821,777,44,49,252,12.7333
25447.29,825,781,44,49,253,12.6333
25459.24,820,777,43,49,251,12.7333
25471.18,825,782,43,50,253,12.5667
25483.09,825,781,44,49,253,12.7
25494.85,820,775,45,48,252,12.8
25507.19,825,781,44,49,254,12.8
25519.07,825,780,45,51,251,13.0333
25530.95,825,782,43,50,253,13.0667
25543.09,824,781,43,51,253,13.3
25554.85,821,777,44,51,252,13.1667
25567.55,824,781,43,51,253,13.0667
25579.42,825,782,43,50,253,13.2333
25591.22,820,776,44,50,252,13.3667
25604.25,825,780,45,51,253,13.6667
25616.06,822,775,47,50,251,13.6333
25628.36,824,781,43,52,253,13.9667
25640.23,826,781,45,51,253,13.9333
25652.02,822,777,45,52,251,14.1
25664.57,825,781,44,51,253,14.2667
25676.47,818,776,42,53,251,14.2
25688.43,825,781,44,52,253,14.0667
25700.35,825,781,44,51,253,14.0667
25712.07,822,776,46,51,252,14.1667
25724.36,823,781,42,53,253,14.2
25736.25,821,777,44,52,252,14.2667
25748.22,826,782,44,52,253,14.2667
25760.09,825,782,43,51,253,14.0667
25771.84,821,776,45,53,252,14.1667
25789.8,825,781,44,51,253,14.1333
25801.64,821,777,44,53,252,14.2667
25814.3,826,781,45,53,253,14.2333
25826.17,826,781,45,51,254,14.5
25837.98,820,776,44,53,251,14.2
25850.93,826,781,45,52,254,14.1333
25862.73,829,781,48,51,253,14.2
25875.51,832,782,50,53,254,14.3
25888.66,832,783,49,53,254,14.3667
25901.3,830,780,50,52,253,14.3667
25914.34,832,783,49,53,254,14.4
25927.09,830,780,50,52,252,14.3
25940.08,831,783,48,53,254,14.2
25952.9,829,779,50,51,253,14.2333
25965.49,828,777,51,54,253,14.1667
25979.24,832,783,49,51,256,14.4
25991.74,828,780,48,52,253,14.3667
26005.16,831,782,49,52,254,14.3
26017.73,829,779,50,52,253,14.1667
26030.28,831,783,48,53,254,14.1333
26043.12,831,783,48,53,253,14.3
26055.5,827,780,47,52,253,14.2333
26068.59,831,783,48,53,254,14.2
26081.09,828,780,48,51,252,14.3333
26093.8,831,783,48,52,254,14.2667
26106.29,827,783,44,52,253,14.3667
26118.65,829,780,49,52,253,14.5333
26131.5,831,783,48,55,254,14.9667
26144.09,828,779,49,55,253,15.5667
26157.03,832,783,49,55,254,15.9667
26169.54,829,780,49,58,253,16.6667
26181.93,826,778,48,58,252,17.2667
26195.53,831,783,48,59,252,17.4333
26208.07,829,779,50,60,252,17.7
26221.27,831,782,49,60,254,17.9333
26233.78,829,780,49,59,253,18.2667
26246.45,828,778,50,60,252,18.3667
26259.64,831,783,48,61,254,18.2333
26272.1,829,780,49,59,253,18.2667
26285.16,830,782,48,60,254,18.6333
26297.75,828,780,48,62,253,18.8667
26310.41,832,783,49,62,254,19.0667
26322.99,831,783,48,62,254,18.7
26335.35,828,779,49,60,253,18.8667
26348.42,832,783,49,62,254,19.0667
26361.47,828,779,49,61,253,18.9667
26374.39,832,782,50,61,254,19.3333
26386.92,831,783,48,64,254,18.9333
26399.48,830,779,51,62,252,19.2
26413.0,832,783,49,61,254,19.2
26425.6,829,780,49,62,252,19.2
26439.03,831,782,49,63,254,19.4333
26451.58,832,783,49,62,254,19.3333
26464.31,827,778,49,63,251,19.3
26477.62,831,783,48,63,254,19.1333
26490.07,827,780,47,64,253,19.5333
26503.08,831,782,49,63,253,19.0
26515.66,827,780,47,64,252,19.4667
26528.52,831,783,48,62,254,19.3
26541.36,831,782,49,63,253,19.6667
26553.85,828,780,48,64,252,19.7667
26567.26,831,783,48,66,254,19.9667
26579.85,829,779,50,67,252,19.9
26593.07,830,782,48,65,254,20.0
26605.6,827,783,44,66,254,19.8667
26618.32,828,780,48,63,253,19.7333
26631.93,832,781,51,64,254,20.0667
26644.52,823,786,37,64,254,20.1333
26657.48,831,783,48,64,253,20.2667
26670.07,828,780,48,66,253,20.4667
26682.79,833,783,50,66,254,20.3
26695.74,831,782,49,66,254,20.2
26708.21,827,779,48,66,253,20.0333
26721.42,831,783,48,66,254,20.2667
26734.0,832,783,49,64,254,20.3667
26746.74,831,783,48,64,254,20.4667
26759.29,831,782,49,65,254,20.6333
26771.8,832,783,49,66,252,20.4333
26785.09,832,783,49,66,254,20.4333
26797.66,831,783,48,68,254,20.6333
26810.48,828,779,49,65,253,20.8667
26823.25,831,782,49,67,253,20.6
26836.03,828,777,51,68,252,20.7
26849.66,830,783,47,66,254,20.6667
26862.31,830,780,50,66,253,20.6333
26875.41,831,783,48,66,254,20.9667
26888.01,831,782,49,66,253,20.8
26900.72,831,783,48,68,254,21.5333
26913.65,831,782,49,69,254,21.6333
26926.08,827,779,48,72,253,22.4333
26939.22,831,783,48,74,254,22.7667
26951.79,825,783,42,75,254,23.1333
26964.53,831,783,48,73,254,23.2667
26977.05,829,781,48,75,254,23.7
26989.49,829,780,49,74,253,23.7333
27002.65,831,783,48,76,253,23.5
27015.22,831,781,50,75,254,23.3667
27028.05,831,783,48,75,254,23.6
27040.58,832,782,50,75,254,23.4667
27053.06,826,779,47,74,251,23.6667
27066.44,831,783,48,76,254,23.9333
27079.06,828,779,49,76,253,23.9333
27092.32,831,781,50,76,254,23.6333
27104.86,831,782,49,76,253,23.4333
27117.75,828,780,48,74,253,23.7
27131.33,831,784,47,74,254,23.5667
27143.92,829,780,49,73,253,23.4333
27156.82,831,783,48,76,254,23.7333
27169.37,829,781,48,75,254,23.7667
27182.09,831,782,49,74,254,23.9667
27194.79,831,782,49,74,255,23.5333
27207.24,828,780,48,76,252,23.5333
27220.19,831,782,49,74,254,23.7333
27232.78,830,778,52,73,253,23.5
27245.69,831,783,48,74,253,23.6
27258.3,826,779,47,71,253,23.6333
27270.9,826,778,48,74,253,23.8333
27284.67,829,782,47,73,253,23.6667
27297.34,827,780,47,74,252,23.7333
27310.42,831,782,49,74,255,24.0333
27322.93,828,778,50,74,252,23.6333
27335.59,831,783,48,73,253,23.7
27348.25,832,782,50,73,254,23.8667
27360.66,826,778,48,77,252,23.8
27373.42,830,782,48,75,253,23.5
27386.2,825,780,45,74,251,23.6333
27399.43,831,783,48,74,254,23.6667
27411.93,828,780,48,75,253,23.6667
27424.43,827,780,47,74,253,23.8667
27437.99,830,782,48,74,253,23.4
27450.52,828,779,49,75,252,23.7333
27463.8,831,783,48,74,253,23.5667
27476.32,829,780,49,75,253,23.9333
27488.95,828,780,48,73,253,23.8667
27502.15,830,782,48,75,253,23.8667
27515.79,829,779,50,75,252,23.7333
27529.36,831,782,49,74,253,23.7
27541.92,828,779,49,74,253,23.7
27555.31,831,783,48,76,253,23.7667
27567.89,832,782,50,75,254,23.8333
27580.51,828,780,48,76,252,23.6667
27594.17,831,782,49,75,254,24.1
27606.72,829,780,49,75,253,23.7333
27619.75,831,783,48,74,254,24.0
27632.34,825,779,46,73,253,23.7333
27645.05,831,783,48,75,254,23.4333
27657.67,832,783,49,73,254,23.8667
27670.07,828,779,49,74,252,23.8333
27682.88,831,782,49,76,254,23.9667
27695.41,828,780,48,75,253,23.8
27708.11,831,783,48,74,255,24.0333
27720.6,832,783,49,74,254,23.8333
27732.93,826,779,47,74,253,23.8
27746.14,831,783,48,74,254,23.7333
27758.62,827,779,48,75,253,23.6667
27771.51,831,783,48,75,254,23.5667
27784.01,828,779,49,74,253,24.1
27796.44,827,779,48,74,254,23.9667
27809.93,831,783,48,75,254,23.9333
27822.44,828,779,49,75,253,23.9333
27835.72,831,782,49,74,254,23.8
27848.28,829,780,49,74,253,23.7333
27860.96,827,778,49,75,252,23.9333
27874.27,833,783,50,73,254,24.0667
27886.75,828,786,42,74,253,23.7667
27899.99,832,783,49,76,254,23.6
27912.51,827,779,48,76,253,23.4333
27925.16,831,782,49,76,254,23.6
27937.77,831,783,48,73,253,23.7333
27950.12,829,780,49,75,253,23.8
27963.2,832,783,49,74,254,23.8333
27976.72,831,782,49,75,255,24.0667
27989.58,832,783,49,75,254,23.5667
28007.31,826,775,51,75,252,24.0333
28029.41,828,779,49,73,252,23.9667
28042.83,829,780,49,75,252,23.9333
28055.5,827,779,48,74,253,23.7333
28068.66,828,780,48,75,253,23.9
28081.43,821,777,44,75,252,23.8
28093.87,820,778,42,75,251,23.6333
28107.28,820,776,44,75,251,23.6667
28120.14,825,781,44,74,254,23.8333
28131.95,820,775,45,74,252,23.9667
28144.61,826,781,45,74,253,24.0333
28156.51,825,780,45,75,253,23.7
28168.41,820,777,43,76,251,23.5667
28181.33,825,780,45,75,253,23.5333
28193.33,825,784,41,76,255,23.8333
28205.34,825,781,44,76,254,23.3667
28217.33,826,781,45,74,254,23.7
28229.22,820,778,42,75,251,24.0333
28242.18,823,781,42,74,253,24.1333
28254.08,825,780,45,76,253,23.8
28266.1,828,775,53,74,255,23.6667
28278.05,825,781,44,75,253,23.8
28289.85,821,777,44,73,252,23.9667
28302.07,827,787,40,75,253,23.7333
28313.97,825,780,45,74,253,23.7
28325.97,825,781,44,73,253,24.0667
28338.05,823,781,42,75,251,24.0
28349.89,818,777,41,76,252,23.9333
28362.47,825,782,43,75,254,23.8667
28374.34,823,781,42,75,253,23.6333
28386.25,825,781,44,74,253,23.6667
28398.57,824,781,43,74,254,23.7333
28410.37,815,776,39,74,252,24.1
28423.0,823,781,42,75,254,23.7
28434.89,824,781,43,74,253,23.8
28446.74,822,776,46,75,251,23.8667
28459.61,825,781,44,75,253,23.9
28471.44,825,780,45,75,253,23.6667
28483.49,826,782,44,74,254,23.5667
28495.4,825,781,44,75,253,23.7333
28507.27,822,777,45,74,251,23.5333
28520.23,825,778,47,73,252,23.6333
28532.16,824,781,43,74,253,23.5
28544.14,825,781,44,76,252,24.1333
28556.05,825,777,48,75,253,24.2333
28567.88,821,776,45,73,251,23.7333
28580.1,825,781,44,73,253,23.7333
28591.98,825,781,44,75,253,23.8667
28604.0,824,782,42,75,254,23.6333
28616.01,824,781,43,72,253,23.8667
28627.83,820,776,44,73,252,23.6333
28640.36,825,782,43,75,253,24.1333
28652.26,825,781,44,75,253,23.7667
28664.11,825,781,44,74,253,23.6
28676.37,825,781,44,73,253,23.9333
28688.16,820,776,44,75,252,23.9667
28700.76,825,781,44,74,253,24.0333
28712.67,825,780,45,74,253,23.9333
28724.56,821,776,45,74,252,23.7333
28737.63,825,781,44,75,252,23.9
28749.49,825,780,45,74,253,23.7667
28761.52,825,781,44,74,253,23.6
28773.41,824,781,43,74,254,23.8667
28785.23,821,777,44,74,251,23.9333
28798.61,830,782,48,75,254,24.0667
28811.13,831,782,49,74,254,24.0667
28823.76,830,782,48,74,253,23.7667
28836.71,831,782,49,76,254,24.0
28849.1,829,780,49,74,253,24.1
28862.29,831,782,49,76,254,23.8667
28874.99,830,782,48,74,253,23.8
28887.75,831,782,49,77,254,23.9333
28900.31,834,782,52,77,254,23.6333
28912.73,829,775,54,75,252,24.0333
28925.96,831,782,49,74,254,23.7667
28938.52,831,782,49,74,254,23.7333
28951.21,831,783,48,75,254,23.5333
28963.74,830,782,48,76,254,23.8667
28976.21,827,780,47,77,252,23.5
28989.45,831,782,49,74,253,23.9667
29002.01,830,782,48,75,253,23.9333
29014.74,831,783,48,75,254,23.9333
29027.33,828,780,48,75,253,23.7
29039.77,827,779,48,76,252,23.6667
29053.3,832,783,49,75,254,23.4
29065.84,827,780,47,75,253,23.6667
29079.07,831,783,48,77,254,23.6667
29091.54,827,779,48,74,252,23.4667
29104.19,828,780,48,74,254,23.9667
29117.53,832,783,49,75,254,23.7333
29129.94,828,779,49,74,251,23.8333
29143.01,831,783,48,75,254,24.2667
29155.51,828,779,49,74,253,23.8667
29168.14,831,783,48,74,254,24.0333
29181.03,831,783,48,77,255,23.8
29193.48,827,779,48,73,253,23.8
29206.54,832,783,49,74,253,23.8333
29219.11,827,779,48,76,251,23.7
29231.78,831,783,48,76,255,24.0
29244.26,831,783,48,75,254,23.8667
29256.6,827,780,47,75,253,23.6333
29269.65,830,782,48,76,254,23.6333
29282.15,825,779,46,76,253,24.0667
29295.11,831,784,47,76,254,23.9333
29307.62,828,779,49,74,253,24.0
29320.17,826,779,47,77,252,23.7667
29333.63,831,782,49,73,254,23.5667
29346.21,829,780,49,77,253,24.1333
29359.4,831,783,48,75,254,24.0
29371.9,828,779,49,75,253,23.9
29384.5,831,783,48,74,254,23.5667
29397.45,831,783,48,74,254,23.9
29409.89,829,780,49,74,253,23.8667
29422.86,831,783,48,73,254,23.7667
29435.37,831,780,51,74,255,23.7667
29448.08,831,783,48,76,254,24.2333
29460.58,832,783,49,75,254,23.7
29472.92,827,780,47,76,253,23.9333
29486.02,831,782,49,76,254,24.0333
29498.53,827,780,47,74,253,23.9333
29511.44,831,783,48,73,254,23.7667
29523.92,831,780,51,75,253,23.9
29536.37,827,779,48,74,252,24.0667
29550.27,830,783,47,75,254,23.8
29563.47,829,779,50,76,253,23.5
29576.74,830,783,47,74,254,23.7
29589.3,830,783,47,76,254,23.9333
29602.02,828,779,49,76,252,23.7667
29615.57,831,788,43,74,254,23.7667
29628.05,828,779,49,75,252,23.9
29640.92,831,783,48,74,254,24.1333
29653.48,830,783,47,76,253,23.7
29666.32,831,783,48,74,254,23.4667
29678.85,831,783,48,76,254,23.9667
29691.27,827,780,47,75,253,23.9
29704.46,831,783,48,74,255,23.8333
29717.02,831,783,48,76,253,23.8333
29729.75,831,783,48,75,254,23.8667
29742.24,832,782,50,76,254,23.6667
29754.73,829,780,49,75,251,23.8667
29768.06,831,783,48,75,254,23.8333
29780.61,830,783,47,78,254,23.4667
29793.33,832,783,49,76,253,23.9667
29806.18,829,781,48,74,253,24.1333
29818.75,827,779,48,76,252,23.7667
29832.43,832,781,51,75,254,23.8667
29845.06,828,779,49,77,252,23.7333
29858.21,831,783,48,75,254,24.0667
29870.85,831,783,48,77,254,23.6667
29883.53,831,783,48,75,254,23.8667
29896.5,831,783,48,74,254,23.9667
29908.93,828,780,48,74,253,23.9667
29921.87,831,784,47,76,255,23.9
29934.42,831,782,49,75,253,23.8333
29947.25,831,782,49,77,254,23.9333
29959.77,831,782,49,76,253,23.9
29972.22,828,780,48,75,252,24.4
29985.47,830,782,48,76,254,23.6
29998.05,831,782,49,76,253,24.1667
30010.74,825,784,41,76,254,24.0667
30023.26,830,782,48,76,253,23.7667
30035.74,828,778,50,75,252,24.0
30049.13,830,782,48,75,254,24.0667
30061.65,828,779,49,75,252,23.5667
30074.54,829,783,46,76,254,24.0667
30087.03,829,780,49,74,253,23.8
30099.41,826,779,47,74,252,24.1
30112.92,831,782,49,74,254,24.0667
30125.4,829,779,50,74,253,23.7333
30138.69,831,783,48,75,253,23.8
30151.21,827,780,47,74,253,23.9667
30163.83,827,778,49,74,252,24.3
30176.97,830,783,47,75,254,24.0
30189.4,828,780,48,75,253,24.1
30202.44,831,783,48,75,254,23.8333
30214.95,828,780,48,75,253,23.8333
30227.59,832,784,48,75,256,23.9
30240.09,829,780,49,75,253,23.8667
30252.89,828,780,48,73,253,24.2
30265.83,829,782,47,76,254,24.1333
30278.43,831,783,48,76,254,23.8333
30291.13,831,782,49,75,254,23.6333
30303.65,830,782,48,77,254,24.0333
30316.14,825,778,47,74,252,24.0667
30329.44,831,782,49,73,254,24.0333
30341.98,831,782,49,74,253,23.5667
30354.72,831,781,50,75,254,23.8667
30367.32,828,779,49,77,253,23.9
30379.78,827,778,49,77,253,23.7333
30393.09,830,782,48,75,253,24.0667
30405.62,828,779,49,76,253,23.8333
30418.91,832,783,49,75,254,23.6
30431.39,828,778,50,74,253,24.0
30444.05,828,778,50,75,252,23.8
30457.18,831,783,48,75,254,24.3667
30469.68,827,778,49,74,252,24.0333
30482.84,832,783,49,76,254,24.0
30495.34,829,780,49,75,253,24.1
30507.96,832,782,50,76,255,23.7667
30520.52,831,783,48,74,254,23.8667
30532.88,828,778,50,73,252,24.0
30545.76,831,782,49,75,254,23.4667
30558.27,830,780,50,72,253,24.2
30570.91,830,782,48,76,254,24.1667
30583.43,830,783,47,76,254,24.1
30595.77,826,779,47,74,253,23.9333
30608.72,830,782,48,75,254,23.5333
30621.22,827,780,47,75,253,23.9
30633.89,831,782,49,77,254,23.8667
30646.46,830,782,48,74,254,23.5667
30658.84,829,778,51,74,252,23.8667
30671.86,831,782,49,77,253,24.0333
30684.38,827,780,47,73,253,24.0
30697.05,831,783,48,76,254,23.8333
30709.56,831,783,48,76,254,24.2
30722.02,828,779,49,74,253,24.1667
30735.21,831,783,48,77,254,24.1333
30747.76,828,779,49,75,253,23.7333
30760.74,830,783,47,76,254,23.3667
30773.23,827,779,48,75,254,23.8333
30785.82,831,773,58,75,253,24.3333
30799.45,830,782,48,77,253,24.3667
30811.94,829,780,49,76,252,24.5667
30825.0,831,782,49,79,254,24.8667
30837.53,828,779,49,79,253,24.7667
30850.21,832,783,49,80,254,24.8667
30862.79,831,783,48,79,254,24.9
30875.14,828,779,49,78,251,25.3667
30888.38,831,783,48,82,253,25.2667
30900.93,828,779,49,80,253,25.4667
30913.95,831,783,48,82,254,25.4333
30927.0,827,776,51,79,252,25.7667
30941.98,827,778,49,82,252,25.8333
30955.6,829,782,47,83,254,26.2
30968.35,827,779,48,84,253,26.4667
30981.36,824,779,45,83,252,26.1667
30994.84,828,780,48,84,253,26.3
31007.5,829,779,50,83,253,26.6
31020.28,825,777,48,84,252,26.7667
31033.22,822,777,45,86,252,26.9333
31045.13,821,777,44,84,252,27.3
31057.33,818,776,42,84,252,27.2333
31069.66,824,782,42,85,253,27.0
31081.5,825,781,44,84,252,27.2333
31093.36,825,781,44,87,253,27.2667
31105.68,824,780,44,88,252,27.5
31118.52,818,777,41,88,252,27.7333
31131.69,825,781,44,86,253,27.3333
31143.57,825,781,44,89,252,28.0
31155.95,826,781,45,88,253,28.3333
31167.96,824,781,43,90,253,27.7333
31179.64,820,777,43,90,252,27.9333
31192.21,824,781,43,90,253,28.3333
31204.08,824,781,43,90,253,27.9667
31216.06,819,776,43,90,251,27.8333
31228.82,825,782,43,88,254,28.1333
31240.58,821,777,44,88,252,28.6
31252.78,825,781,44,91,254,28.2667
31264.64,824,781,43,89,253,28.5333
31276.43,821,777,44,91,252,28.4333
31289.6,823,781,42,91,252,28.0
31301.43,818,776,42,93,252,28.4
31313.41,825,783,42,91,253,28.5333
31325.31,822,781,41,90,253,28.7
31337.12,821,777,44,93,252,29.0333
31350.48,824,781,43,92,253,29.3
31362.4,821,776,45,93,253,28.6333
31374.31,826,781,45,92,253,29.2333
31386.21,824,781,43,94,254,29.1333
31397.95,820,777,43,94,252,29.0667
31410.31,824,781,43,95,253,29.6
31422.22,823,778,45,94,251,29.9333
31434.16,825,783,42,96,253,29.7
31446.15,825,781,44,97,253,30.1
31457.93,821,777,44,96,252,30.1333
31470.62,819,782,37,94,253,29.7
31482.77,826,781,45,98,254,30.2667
31494.63,821,781,40,94,254,29.9667
31506.9,825,777,48,97,252,30.1667
31518.68,818,778,40,99,252,29.6667
31530.94,824,782,42,98,253,30.2333
31542.86,820,781,39,97,253,30.1333
31554.64,820,777,43,101,252,30.3667
31567.75,823,779,44,100,253,29.7333
31579.63,819,776,43,100,252,30.6
31591.59,826,782,44,98,253,30.8333
31603.47,824,782,42,102,253,31.1
31617.43,824,780,44,98,253,30.8
31629.53,824,781,43,99,254,30.8333
31641.37,820,776,44,100,252,31.0333
31653.33,824,781,43,103,253,30.9333
31665.19,825,781,44,101,253,30.9667
31676.95,824,780,44,102,253,30.9667
31688.99,825,781,44,101,253,31.3
31700.85,820,777,43,103,252,31.3667
31712.79,825,781,44,105,253,31.4667
31724.63,824,781,43,105,254,32.0
31736.34,830,782,48,106,253,31.9667
31749.25,832,782,50,105,254,31.9333
31761.7,827,780,47,102,253,32.2333
31774.17,832,782,50,109,252,32.0333
31787.12,831,782,49,110,254,32.7667
31799.76,831,782,49,109,254,32.9333
31812.63,831,782,49,109,254,32.3333
31825.1,827,779,48,111,253,31.7333
31837.66,825,778,47,110,252,32.5
31850.86,829,783,46,110,253,32.8
31863.13,826,779,47,108,253,32.7333
31875.82,830,783,47,107,254,32.5667
31888.27,827,779,48,106,252,33.2
31900.69,830,777,53,111,254,32.4667
31913.04,830,782,48,111,254,32.5333
31925.28,825,779,46,108,252,32.9333
31938.2,831,783,48,110,254,32.3333
31950.97,828,779,49,107,253,33.6333
31963.65,831,783,48,111,254,32.9333
31976.26,831,782,49,109,254,33.2333
31988.96,828,779,49,109,253,32.9
32001.82,831,783,48,109,254,33.1667
32014.37,827,780,47,108,253,32.9333
32027.58,825,782,43,112,253,32.5
32040.11,826,779,47,110,252,32.7
32052.78,828,780,48,109,252,32.6667
32067.0,831,783,48,111,254,32.7
32079.48,828,780,48,111,253,33.0
32092.54,830,782,48,112,254,33.0
32105.05,828,780,48,113,253,33.5667
32117.92,831,783,48,112,254,33.9667
32130.45,831,783,48,114,253,33.2333
32142.9,827,779,48,111,252,34.1
32156.14,831,783,48,117,254,33.6667
32168.66,828,779,49,119,253,34.1333
32181.7,832,783,49,115,254,34.9
32194.24,828,779,49,120,253,34.5667
32206.84,829,784,45,117,252,35.5333
32220.49,831,783,48,120,253,35.8
32233.3,829,780,49,123,253,35.6667
32246.47,831,782,49,121,254,35.0
32259.02,828,780,48,123,253,36.3333
32271.67,830,783,47,122,253,35.9333
32284.55,831,782,49,126,254,35.2
32296.91,828,778,50,124,255,36.6667
32309.92,831,783,48,127,254,36.4
32322.74,828,779,49,125,253,35.8333
32336.11,831,783,48,129,254,36.3
32348.68,827,779,48,129,253,36.7
32361.34,829,778,51,132,253,37.7
32374.96,829,782,47,129,254,36.5667
32387.59,827,780,47,128,251,37.9333
32400.9,831,782,49,135,254,38.6333
32413.44,828,780,48,134,252,38.0667
32426.11,831,783,48,135,254,37.8333
32438.66,831,782,49,138,254,37.3333
32451.24,828,779,49,140,253,38.6333
32464.56,831,783,48,143,254,38.7667
32477.18,828,779,49,136,253,39.1
32490.17,831,783,48,143,254,38.6333
32502.67,827,779,48,142,253,39.1667
32515.3,827,779,48,142,252,40.5
32529.06,831,783,48,146,255,40.8333
32541.58,828,779,49,142,253,40.4333
32554.79,830,782,48,146,254,40.5667
32567.74,827,783,44,151,253,41.7667
32580.42,831,783,48,150,254,41.8667
32593.01,831,783,48,150,254,40.7667
32605.4,827,780,47,152,253,41.6
32618.76,830,783,47,157,254,42.6
32631.31,827,779,48,151,253,42.1667
32644.47,831,783,48,158,254,42.6333
32656.97,828,773,55,158,253,42.9667
32669.61,828,778,50,162,253,43.0667
32683.75,829,781,48,160,254,43.7333
32696.44,828,780,48,159,252,43.3
32709.6,831,783,48,159,254,43.9
32722.14,826,779,47,163,253,43.1667
32734.88,831,783,48,160,254,43.9
32747.48,827,783,44,169,253,43.5667
32759.87,828,779,49,167,253,44.4333
32772.77,831,783,48,167,254,44.0
32785.31,827,777,50,167,252,44.5
32798.47,831,783,48,173,254,43.7333
32811.01,829,780,49,177,253,45.7
32823.59,828,778,50,169,252,43.9333
32837.36,830,781,49,169,254,44.7667
32850.17,828,779,49,175,252,43.9667
32863.3,830,783,47,171,254,43.8667
32875.84,826,777,49,166,253,44.5667
32888.76,831,783,48,172,254,44.7667
32901.22,831,782,49,172,254,44.4667
32913.48,830,782,48,170,254,44.5333
32926.13,832,783,49,170,254,44.7333
32938.61,828,780,48,169,253,45.4333
32951.24,831,783,48,174,253,44.9667
32963.75,832,780,52,166,254,44.6667
32976.09,828,780,48,174,253,44.9
32988.98,831,783,48,175,255,44.1333
33001.54,831,782,49,175,253,46.8333
33014.29,831,783,48,169,254,45.8
33026.75,828,780,48,172,253,44.2
33039.18,829,781,48,172,254,45.1333
33051.84,831,783,48,174,254,45.1667
33064.38,826,779,47,172,254,45.1
33077.7,829,782,47,169,253,44.4
33094.48,827,779,48,172,253,44.8333
33107.61,831,778,53,175,254,44.2333
33119.9,826,779,47,176,252,45.2667
33133.75,829,783,46,174,253,44.3667
33146.52,830,782,48,168,253,45.0333
33158.76,825,779,46,173,253,44.2333
33171.56,831,783,48,176,253,46.1
33184.36,828,780,48,171,253,44.4
33197.04,831,784,47,178,252,45.2333
33209.66,831,783,48,173,254,45.5667
33222.05,825,778,47,165,253,44.2667
33235.28,831,782,49,169,254,44.9333
33247.93,827,779,48,172,253,45.0333
33260.95,831,781,50,173,254,43.9667
33273.48,828,780,48,177,252,44.9667
33286.01,821,779,42,174,255,45.3333
33300.32,830,782,48,172,254,44.5333
33312.86,829,779,50,169,253,44.4333
33326.13,831,783,48,173,254,45.2
33338.69,828,780,48,167,253,45.2667
33351.64,827,781,46,170,253,44.7
33364.87,831,783,48,170,254,43.9667
33377.42,831,780,51,171,251,45.3667
33390.44,831,781,50,171,254,44.9667
33402.98,828,780,48,169,253,45.5333
33416.68,831,783,48,175,254,45.3333
33429.22,828,780,48,168,253,45.4667
33441.79,828,780,48,173,253,45.0667
33455.43,830,780,50,172,254,45.1333
33468.21,828,780,48,169,253,44.7667
33481.39,831,783,48,170,253,44.8667
33493.95,827,780,47,173,253,45.8667
33506.61,830,783,47,169,254,45.3667
33519.2,831,783,48,172,254,45.1667
33531.55,827,779,48,169,253,45.7
33544.46,831,783,48,167,254,45.4333
33556.97,829,779,50,176,253,45.2
33569.68,831,782,49,176,254,45.0333
33582.25,832,783,49,171,254,44.2
33594.7,828,780,48,168,253,45.3333
33607.62,829,782,47,174,254,44.5667
33620.16,828,779,49,174,252,44.7667
33633.95,831,783,48,172,254,44.5333
33646.48,827,780,47,170,253,44.9
33663.26,831,782,49,175,253,45.3
33675.94,827,780,47,174,253,45.3
33688.62,830,782,48,170,254,44.7
33701.27,831,783,48,172,253,45.8
33713.76,830,782,48,173,254,45.2
33726.58,831,783,48,173,254,45.9667
33739.11,827,780,47,172,253,45.4
33751.64,831,782,49,173,254,44.9
33764.57,831,783,48,168,253,45.7333
33777.22,829,781,48,173,254,45.5667
33789.75,829,783,46,172,253,44.8333
33802.05,827,780,47,173,252,45.7
33814.41,830,781,49,172,253,44.8333
33827.45,831,789,42,172,252,45.5333
33839.83,825,778,47,172,252,44.1333
33853.68,827,778,49,175,253,45.3
33867.41,824,776,48,172,252,46.1333
33881.07,828,777,51,172,253,44.8333
33894.41,826,776,50,169,252,45.8667
33907.05,829,779,50,167,253,45.0
33920.72,828,780,48,172,253,45.7333
33933.57,828,780,48,171,253,44.9
33946.14,827,780,47,175,253,45.0667
33959.22,829,780,49,177,253,44.8
33972.47,824,787,37,171,254,45.1667
33984.5,824,781,43,172,253,45.6667
33996.28,821,776,45,171,251,45.2667
34009.15,825,781,44,171,253,44.8667
34020.93,817,776,41,174,251,45.5
34033.46,825,782,43,173,253,44.7
34045.33,824,781,43,175,253,44.4333
34057.07,820,777,43,175,252,45.4667
34070.13,824,781,43,176,253,45.0333
34081.98,820,776,44,167,252,45.0667
34093.99,825,781,44,173,254,44.7333
34105.91,824,781,43,171,253,45.0333
34117.77,820,777,43,171,252,45.6667
34129.98,825,781,44,171,253,45.3667
34141.85,822,776,46,170,252,45.1
34153.82,825,781,44,167,253,44.4333
34166.0,825,779,46,169,253,44.2667
34177.86,819,778,41,171,252,45.4333
34190.41,825,781,44,174,254,45.0
34202.29,824,781,43,167,252,45.2667
34214.1,825,781,44,169,253,44.4333
34226.15,824,780,44,172,253,44.6333
34237.98,820,777,43,174,251,45.9667
34251.03,825,781,44,174,254,45.3667
34262.92,825,781,44,172,254,45.4
34274.73,819,778,41,170,253,45.6333
34287.05,823,781,42,169,253,44.0333
34298.79,819,776,43,165,252,43.9667
34311.09,825,782,43,167,254,44.3667
34323.0,825,781,44,165,253,45.2333
34334.84,819,777,42,170,252,44.1
34348.43,823,781,42,167,253,44.5667
34360.47,818,777,41,167,252,43.4667
34372.77,825,781,44,166,253,43.6333
34384.67,824,781,43,169,254,43.2
34396.42,820,777,43,162,252,44.5667
34409.51,825,781,44,162,254,44.5
34421.4,812,776,36,159,252,43.2
34433.41,823,782,41,167,253,43.3
34445.32,824,781,43,165,253,43.8333
34457.23,821,776,45,164,252,44.1
34469.44,825,781,44,165,254,44.7667
34481.33,820,777,43,167,252,43.9
34493.28,831,781,50,162,253,43.8
34505.2,825,781,44,167,253,43.1667
34517.03,820,778,42,161,253,42.6667
34529.65,824,777,47,157,252,43.0333
34541.53,823,779,44,164,252,43.6667
34553.41,824,781,43,162,253,43.2667
34565.73,824,781,43,162,254,42.8333
34577.52,820,777,43,162,253,42.5333
34590.16,825,781,44,158,253,42.4667
34602.06,831,783,48,153,254,42.1333
34613.81,820,776,44,159,251,42.2333
34626.7,825,781,44,151,253,41.9
34638.59,818,776,42,153,252,41.3333
34650.83,825,782,43,150,253,40.9333
34662.72,825,782,43,152,254,41.8333
34674.48,821,783,38,144,252,40.6667
34687.41,831,783,48,147,254,40.1667
34700.14,827,780,47,146,253,40.5333
34712.84,831,783,48,143,254,40.0
34725.45,831,783,48,142,254,39.7667
34737.91,824,777,47,143,252,40.1667
34751.86,828,779,49,141,253,39.7667
34765.46,827,780,47,140,253,39.8667
34779.02,831,783,48,138,253,38.2333
34791.57,830,783,47,134,253,39.7667
34804.34,827,779,48,135,253,37.8
34817.98,831,779,52,131,254,37.4
34830.42,828,780,48,133,253,37.9333
34843.19,831,783,48,130,254,37.1
34855.95,830,782,48,129,254,37.3333
34868.69,830,783,47,131,254,36.9
34881.27,831,782,49,128,254,36.8333
34893.88,827,778,49,129,252,37.4333
34907.12,839,783,56,132,254,36.1
34919.81,829,780,49,129,252,37.4667
34933.71,831,783,48,127,254,37.1333
34946.29,831,783,48,128,254,36.2
34958.95,829,783,46,129,254,37.1333
34972.0,831,783,48,128,253,36.8333
34984.65,827,780,47,131,253,38.0
34997.85,829,789,40,127,254,36.3
35010.42,830,782,48,121,254,35.9667
35027.3,831,783,48,119,254,34.6
35040.01,826,780,46,114,253,33.0667
35052.68,831,783,48,108,253,33.1667
35065.15,831,783,48,106,254,32.5333
35077.49,830,782,48,106,254,31.1667
35090.15,829,782,47,104,253,31.3
35102.44,827,779,48,100,254,30.7333
35114.95,830,783,47,97,254,30.3333
35127.28,829,782,47,95,254,30.0333
35139.42,828,782,46,92,253,29.1333
35151.88,830,782,48,89,254,27.8
35164.17,827,780,47,87,254,27.3
35176.71,830,783,47,85,253,26.8667
35189.01,830,783,47,82,254,26.7
35201.41,831,782,49,82,254,25.6667
35214.13,831,777,54,77,253,25.1667
35226.62,827,780,47,74,253,23.9
35239.3,830,783,47,70,253,23.2
35251.77,831,783,48,68,254,21.6
35264.06,830,782,48,66,254,20.6333
35276.73,832,782,50,63,254,19.6667
35289.21,828,779,49,59,253,18.9667
35301.83,831,783,48,58,254,17.7333
35314.29,831,783,48,56,254,16.8333
35326.66,831,782,49,55,254,15.9667
35339.36,829,779,50,53,253,14.5
35351.84,827,780,47,51,253,13.4
35364.5,831,783,48,50,254,12.7667
35376.96,830,782,48,49,253,12.2
35389.25,828,782,46,49,253,11.9333
35401.78,830,783,47,47,254,11.6
35414.08,827,782,45,48,254,10.9333
35426.62,829,783,46,46,253,9.9
35438.97,830,783,47,45,253,8.5
35451.24,828,782,46,44,253,6.9667
35463.75,830,782,48,43,253,5.5667
35476.05,827,779,48,43,254,4.3667
35488.57,829,783,46,42,254,3.5333
35500.86,829,782,47,44,254,2.9667
35513.0,829,781,48,43,254,2.4333
35525.47,829,782,47,42,254,1.7333
35537.85,822,779,43,42,253,1.0
35550.34,830,783,47,42,253,0.3333
35562.62,830,782,48,42,254,-0.0667
35574.74,831,782,49,41,253,-0.2
35587.28,830,782,48,42,254,-0.1667
35599.72,829,780,49,41,254,0.0
35612.36,831,783,48,42,254,0.0667
35624.79,832,782,50,42,254,0.1667
35637.27,830,782,48,42,253,0.1667
35649.98,831,783,48,42,254,0.1333
35662.47,828,780,48,42,251,0.0333
35675.39,831,783,48,42,253,0.0
35687.89,827,779,48,42,252,-0.0333
35700.35,831,778,53,42,252,-0.0333
35713.7,831,783,48,42,254,0.0
35726.22,828,779,49,42,253,0.0333
35739.5,831,782,49,42,253,0.0667
35752.16,829,780,49,43,253,0.0333
35764.84,830,783,47,43,253,0.0333
35777.67,831,783,48,42,254,0.0
35790.19,830,783,47,43,254,0.0333
35802.86,831,783,48,41,254,0.0333
35815.34,827,780,47,42,253,0.0
35828.05,831,781,50,42,253,0.0
35840.7,829,783,46,41,254,0.0333
35853.22,830,783,47,41,254,0.0333
35865.99,829,783,46,42,254,0.0
35878.49,827,778,49,42,253,0.0
35891.0,830,783,47,42,253,0.0
35903.29,828,781,47,43,253,0.0
35915.38,831,781,50,42,254,0.0
35927.96,829,782,47,43,253,0.0333
35940.25,827,779,48,42,252,0.0
35952.69,830,782,48,43,254,0.0
35964.95,830,782,48,43,253,0.0
35977.23,828,782,46,42,253,0.0
35990.88,827,780,47,42,252,0.0
36003.56,827,779,48,43,251,0.0
36017.4,831,783,48,42,253,0.0
36029.91,827,779,48,43,253,-0.0333
36042.53,828,779,49,42,252,0.0
36056.17,830,782,48,42,253,-0.0333
36068.76,828,780,48,41,253,0.0
36081.9,829,783,46,42,254,0.0
36094.46,827,780,47,41,251,0.0
36107.04,831,782,49,42,254,0.0
36119.59,831,783,48,41,254,0.0
36131.96,830,779,51,42,255,0.0
36144.8,831,783,48,42,254,0.0
36157.35,829,779,50,41,252,0.0
36170.08,830,782,48,42,254,0.0
36182.92,829,783,46,43,254,0.0
36195.39,825,779,46,43,252,0.0
36208.79,832,783,49,42,254,0.0
36221.31,824,778,46,41,254,0.0
36234.7,830,783,47,42,253,0.0
36247.26,828,779,49,41,252,0.0
36259.93,827,778,49,42,252,0.0
36273.51,830,782,48,41,252,0.0
36286.11,827,780,47,42,253,0.0
36299.63,832,783,49,42,253,0.0
36312.17,827,780,47,42,253,0.0
36324.81,830,783,47,42,254,0.0
36337.41,830,783,47,42,254,0.8
36350.05,828,779,49,41,252,0.4
36363.25,831,783,48,41,254,0.1
36375.78,827,779,48,42,252,0.0333
36389.16,832,783,49,43,253,-0.2667
36401.71,831,781,50,42,250,-0.1667
36414.35,827,779,48,42,252,-0.1
36427.66,831,783,48,42,254,0.0
36440.27,827,780,47,42,253,0.0667
36453.57,830,783,47,42,253,0.0667
36466.44,826,779,47,41,253,0.0333
36479.16,831,783,48,43,253,0.0
36492.01,832,777,55,42,253,0.0
36504.56,826,779,47,42,252,-0.0333
36517.62,831,782,49,42,254,-0.0333
36530.16,828,780,48,42,252,-0.0333
36542.93,831,783,48,42,254,0.0
36555.61,831,783,48,42,254,0.0
36568.03,827,778,49,42,252,-0.0333
36581.32,832,784,48,43,256,0.0
36593.86,827,779,48,43,252,0.0333
36606.92,831,783,48,42,253,0.0
36619.41,827,779,48,43,252,0.0
36632.35,828,779,49,41,252,-0.0333
36645.95,831,783,48,42,253,0.0
36658.46,828,779,49,42,252,0.0
36671.59,831,780,51,41,254,-0.0333
36684.15,828,779,49,41,253,0.0
36696.82,831,783,48,41,253,0.0
36709.43,832,783,49,42,254,0.0
36721.84,828,780,48,42,252,0.0
36735.17,829,781,48,42,254,0.0
36747.72,827,779,48,41,252,0.0
36760.87,831,783,48,43,254,0.0
36773.4,827,779,48,42,253,0.0
36786.04,827,778,49,42,253,0.0
36800.44,831,783,48,42,253,-0.0333
36813.1,831,778,53,42,252,-0.0333
36829.17,828,779,49,42,253,-0.0333
36841.88,826,777,49,42,252,0.0
36855.5,828,780,48,43,253,-0.0333
36868.8,827,780,47,43,253,0.0
36881.47,829,779,50,42,253,-0.0333
36894.71,828,780,48,43,253,-0.0333
36907.24,816,774,42,41,250,0.0
36919.65,820,777,43,43,252,0.0
36932.46,824,781,43,42,253,0.0
36944.45,820,778,42,43,252,0.0
36956.95,823,781,42,42,253,0.0
36968.81,824,781,43,42,253,0.0
36980.59,825,781,44,41,253,0.0
36992.72,824,782,42,42,253,0.0
37004.44,820,776,44,41,253,0.0
37016.98,825,781,44,40,253,0.0
37028.82,825,782,43,41,253,0.0
37040.55,819,777,42,42,251,0.0
37053.44,825,781,44,42,253,0.0
37066.39,821,777,44,42,252,0.0
37079.12,825,782,43,41,253,0.0
37091.0,819,776,43,42,252,0.0
37103.16,820,775,45,41,251,0.0
37115.65,825,781,44,42,253,0.0
37127.41,818,777,41,42,252,0.0
37139.54,827,780,47,42,253,0.0
37151.37,824,781,43,41,253,0.0
37163.06,821,777,44,42,252,0.0
37175.73,825,782,43,41,254,0.0
37187.57,820,776,44,42,251,0.0
37199.49,823,780,43,42,253,0.0
37211.34,823,776,47,41,255,0.0
37223.08,819,776,43,40,252,-0.0333
37235.19,824,781,43,41,253,0.0
37247.01,819,776,43,42,252,0.0
37258.9,825,780,45,42,252,0.0
37270.71,824,780,44,41,253,0.0
37282.42,820,776,44,41,251,0.0
37294.9,824,780,44,41,253,0.0
37306.7,824,780,44,42,253,0.0
37318.53,824,780,44,42,252,0.0
37330.7,824,780,44,41,253,0.0
37342.45,820,776,44,41,251,0.0
37354.9,824,780,44,41,250,0.0
37366.76,826,781,45,42,253,0.0
37378.5,819,776,43,42,252,0.0
37391.1,828,776,52,41,255,0.0
37402.94,819,776,43,41,251,0.0
37414.84,824,780,44,42,253,0.0
37426.68,823,780,43,42,253,0.0
37438.5,819,776,43,41,252,0.0
37450.59,824,780,44,42,252,0.0
37462.43,819,776,43,41,252,0.0
37474.26,824,780,44,41,253,0.0
37486.09,823,775,48,42,253,0.0
37497.78,820,777,43,42,252,0.0
37510.28,824,781,43,41,253,0.0
37522.11,823,780,43,41,252,0.0333
37533.9,819,774,45,42,251,0.0
37546.58,824,781,43,40,253,0.0
37558.32,819,777,42,42,252,0.0
37570.29,824,780,44,41,253,0.0333
37582.12,822,779,43,41,253,-0.0333
37593.87,820,776,44,41,251,0.0
37606.55,824,780,44,41,252,0.0
37618.4,827,779,48,42,252,0.0
37630.97,831,782,49,41,253,0.0
37643.78,831,778,53,42,254,0.0333
37656.12,827,779,48,42,253,0.0
37668.99,829,782,47,42,253,0.0
37681.44,827,779,48,43,253,0.0
37693.97,830,782,48,42,254,0.0
37706.49,829,781,48,42,253,0.0
37718.82,826,778,48,42,253,0.0
37731.74,830,782,48,42,253,0.0
37744.19,828,778,50,42,253,0.0333
37756.73,829,782,47,41,253,0.0
37769.19,830,782,48,42,254,0.0
37781.49,830,782,48,42,253,0.0
37794.2,828,779,49,41,252,0.0
37806.91,830,782,48,42,253,0.0
37819.37,826,779,47,41,252,0.0
37832.43,829,782,47,43,254,0.0
37844.95,831,782,49,42,252,0.0
37857.79,829,782,47,42,253,0.0
37870.24,830,781,49,41,252,0.0
37882.61,828,778,50,41,252,0.0
37895.94,829,782,47,41,253,0.0
37908.42,830,782,48,42,253,0.0
37921.08,826,782,44,42,254,0.0
37933.58,829,780,49,43,253,0.0
37945.98,826,778,48,41,252,0.0
37959.09,829,782,47,41,253,0.0
37971.59,830,782,48,42,253,0.0
37984.33,830,782,48,42,254,0.0
37996.79,830,782,48,42,253,0.0
38009.19,826,779,47,41,251,0.0
38022.3,830,782,48,41,253,0.0
38034.82,826,778,48,42,252,0.0
38047.77,830,781,49,42,253,0.0
38060.24,826,779,47,41,253,0.0333
38072.63,826,778,48,43,252,0.0
38086.11,830,782,48,41,253,0.0
38098.55,829,779,50,43,253,0.0
38111.74,826,782,44,42,253,0.0
38124.15,827,778,49,41,253,0.0
38136.75,827,778,49,42,251,0.0
38149.76,828,780,48,42,254,0.0
38162.12,827,778,49,42,253,0.0
38175.1,830,782,48,41,254,0.0333
38187.56,827,778,49,41,252,0.0
38200.17,830,782,48,42,254,0.0
38212.78,830,782,48,41,253,0.0
38225.22,826,779,47,41,252,0.0
38238.2,830,782,48,42,253,0.0
38250.67,827,779,48,42,253,0.0
38263.27,831,782,49,42,254,0.0
38275.69,830,782,48,42,253,0.0
38288.07,827,779,48,43,252,0.0
38301.02,830,782,48,43,253,0.0
38313.48,827,778,49,42,252,0.0
38326.46,831,782,49,41,254,0.0
38338.94,827,779,48,42,252,0.0
38351.5,826,778,48,42,252,0.0
38364.97,830,781,49,43,254,0.0
38377.45,826,779,47,41,253,0.0
38390.65,830,782,48,42,253,0.0
38403.1,826,779,47,43,253,0.0
38415.67,828,782,46,43,254,0.0
38428.46,831,781,50,41,254,-0.0333
38440.79,827,779,48,42,252,0.0
38453.63,830,779,51,42,254,0.0
38467.29,827,778,49,41,252,0.0
38479.97,830,782,48,42,253,0.0
38492.44,831,782,49,42,254,0.0
38504.77,827,779,48,42,252,0.0
38518.08,831,782,49,42,253,0.0
38530.55,826,778,48,41,252,0.0
38543.57,832,783,49,43,251,0.0
38556.03,826,779,47,42,252,0.0
38568.72,826,778,48,42,252,0.0
38582.67,829,780,49,42,253,0.0
38595.18,828,779,49,41,252,0.0
38608.23,832,781,51,42,253,0.0
38620.76,826,779,47,43,252,0.0
38633.58,830,784,46,42,254,0.0
38646.12,831,782,49,42,254,0.0
38658.49,828,779,49,42,252,-0.0333
38671.67,830,781,49,42,253,0.0
38684.5,827,779,48,42,253,0.0
38697.77,830,781,49,42,253,0.0
38710.29,826,779,47,42,252,0.0
38723.04,828,784,44,42,252,0.0
38736.53,830,782,48,41,253,0.0
38749.33,828,779,49,42,253,0.0
38762.42,831,782,49,42,253,0.0
38774.96,826,778,48,41,252,0.0
38787.62,829,782,47,42,253,0.0
38800.49,830,781,49,42,253,0.0
38812.92,831,777,54,41,252,0.0
38826.15,831,782,49,42,253,0.0
38838.67,827,778,49,41,253,0.0
38852.27,831,782,49,43,253,0.0
38864.79,827,779,48,42,252,0.0
38877.47,827,778,49,42,251,0.0
38891.01,828,782,46,41,253,0.0
38903.52,827,779,48,42,253,0.0
38917.02,830,782,48,42,253,0.0
38929.57,827,779,48,42,253,0.0
38942.17,831,782,49,42,254,0.0
38954.71,830,782,48,42,254,0.0
38967.35,827,777,50,42,251,0.0
38980.58,830,782,48,42,254,0.0
38993.14,832,777,55,42,251,0.0
39006.41,830,782,48,43,253,0.0
39018.97,827,779,48,42,252,0.0
39031.59,825,777,48,41,252,0.0
39045.26,830,782,48,43,253,0.0
39057.75,827,779,48,42,252,0.0
39070.81,830,781,49,42,254,0.0
39083.65,823,779,44,41,253,0.0
39096.28,831,782,49,41,254,0.0
39108.8,831,782,49,41,254,0.0
39121.24,827,779,48,41,253,0.0
39134.47,830,782,48,42,253,0.0
39147.04,827,779,48,42,253,0.0
39159.91,830,780,50,42,253,0.0
39172.45,830,782,48,42,253,0.0
39184.83,827,777,50,42,252,0.0
39198.18,829,781,48,42,253,0.0
39210.74,827,777,50,42,252,0.0
39223.8,831,782,49,42,253,0.0
39236.34,826,779,47,42,252,0.0
39252.72,831,782,49,42,254,0.0
39265.25,830,782,48,42,254,0.0
39277.71,826,779,47,41,252,0.0
39290.85,830,782,48,42,254,0.0
39303.39,827,778,49,42,253,0.0
39317.29,830,779,51,42,255,0.0
39329.81,827,779,48,42,253,0.0
39342.53,826,777,49,42,252,0.0
39356.17,830,782,48,43,254,0.0
39368.73,827,778,49,42,252,0.0
39381.82,830,781,49,41,253,0.0
39394.38,828,779,49,43,252,0.0
39406.96,831,779,52,42,253,0.0
39419.47,830,782,48,42,253,0.0
39431.82,823,775,48,42,251,0.0
39444.92,831,783,48,41,253,0.0
39457.49,827,779,48,43,252,0.0
39470.24,830,782,48,43,253,0.0
39483.1,825,779,46,42,252,0.0
39495.53,827,777,50,43,252,0.0
39509.24,830,782,48,42,253,0.0
39522.32,828,779,49,41,252,0.0
39535.45,830,782,48,43,253,0.0
39548.05,827,779,48,42,252,0.0
39560.71,828,782,46,42,253,0.0
39573.8,829,780,49,42,253,0.0
39586.26,827,774,53,42,252,0.0
39599.67,830,782,48,41,254,0.0
39612.22,827,775,52,42,253,-0.0333
39625.01,830,782,48,42,254,0.0
39637.62,829,782,47,42,254,0.0
39650.26,824,777,47,42,252,0.0
39663.62,830,782,48,41,253,0.0333
39676.16,827,779,48,41,252,0.0
39689.27,829,780,49,42,254,0.0
39701.79,827,778,49,41,252,0.0
39714.46,827,777,50,41,252,0.0
39727.95,829,782,47,42,253,0.0
39740.46,826,778,48,41,253,0.0
39753.55,830,782,48,43,253,0.0
39766.41,826,779,47,43,251,0.0
39779.09,831,782,49,43,253,0.0
39791.61,829,782,47,42,254,0.0
39804.0,827,778,49,41,252,0.0
39818.0,830,782,48,42,253,0.0
39830.55,827,778,49,41,252,0.0
39843.96,830,782,48,42,253,0.0
39856.51,827,778,49,42,252,0.0
39869.19,831,782,49,42,254,0.0
39882.55,831,782,49,41,253,0.0
39895.03,827,779,48,42,253,0.0
39908.16,832,782,50,42,253,0.0
39920.69,826,779,47,42,253,0.0
39933.67,830,782,48,42,254,0.0
39946.2,829,782,47,42,253,0.0
39958.55,827,777,50,42,252,0.0
39971.64,830,781,49,41,253,0.0
39984.54,827,778,49,41,252,0.0
40003.12,830,782,48,42,253,0.0
40016.36,826,777,49,42,252,0.0
40029.7,831,782,49,43,254,0.0
40047.95,824,776,48,42,251,0.0
40070.14,823,776,47,42,252,0.0
40083.35,828,779,49,42,252,0.0
40095.67,825,778,47,42,252,0.0
40108.43,823,775,48,41,251,0.0
40120.8,827,779,48,42,252,0.0
40133.08,825,779,46,42,252,0.0
40146.02,824,779,45,42,254,0.0
40158.62,823,780,43,41,253,0.0
40170.83,818,777,41,41,251,0.0
40183.5,825,781,44,42,253,0.0
40195.33,825,781,44,41,253,0.0
40207.04,819,775,44,42,251,0.0
40219.79,824,780,44,40,253,0.0
40231.64,820,775,45,41,251,0.0
40243.85,824,780,44,42,253,0.0
40255.68,824,780,44,41,253,0.0
40267.41,819,776,43,42,252,0.0
40280.38,824,781,43,42,253,0.0
40292.21,819,775,44,41,251,0.0
40304.13,823,780,43,41,253,0.0
40315.98,825,780,45,42,253,0.0
40327.73,821,776,45,41,252,0.0
40339.85,824,781,43,42,253,0.0333
40351.68,820,776,44,41,252,0.0
40363.52,824,780,44,41,253,0.0
40375.34,827,780,47,41,253,0.0
40387.03,820,776,44,42,251,0.0
40399.66,824,780,44,41,253,0.0
40411.48,824,779,45,42,252,0.0
40423.21,820,775,45,41,251,0.0
40435.95,824,781,43,42,253,0.0
40447.71,821,776,45,42,252,0.0
40459.88,824,781,43,41,253,0.0
40471.7,823,780,43,41,253,0.0
40483.39,820,777,43,42,251,0.0
40496.43,823,779,44,42,253,0.0
40508.27,819,775,44,42,252,-0.0333
40520.19,824,780,44,41,253,0.0
40532.05,823,780,43,41,253,0.0
40544.01,819,776,43,41,251,0.0
40556.18,824,780,44,42,253,0.0
40568.06,820,776,44,40,251,0.0
40579.91,824,780,44,42,253,0.0
40591.72,823,780,43,42,253,0.0
40603.42,820,772,48,41,250,0.0
40616.1,825,780,45,41,252,0.0
40627.98,824,781,43,42,253,0.0
40639.69,820,776,44,41,252,0.0
40652.52,823,781,42,41,253,0.0
40664.27,819,775,44,41,251,0.0
40676.44,824,781,43,42,253,0.0
40688.28,824,780,44,41,253,0.0
40699.97,820,776,44,43,251,0.0
40712.67,824,780,44,41,253,0.0
40724.48,820,776,44,42,252,0.0
40736.39,824,780,44,41,253,0.0
40748.23,824,780,44,41,252,0.0
40759.96,820,777,43,41,252,0.0
40772.1,824,780,44,41,253,0.0
40783.93,819,776,43,42,251,0.0
40795.8,824,781,43,41,252,0.0
40807.64,825,780,45,42,253,0.0
40819.32,819,775,44,42,253,0.0
40831.85,824,780,44,42,252,0.0
40843.69,824,780,44,42,252,0.0
40855.41,820,776,44,41,251,0.0
40868.18,831,782,49,42,254,0.0
40880.48,827,779,48,42,253,0.0
40893.02,830,782,48,42,254,0.0
40905.45,830,782,48,41,253,0.0
40917.74,827,778,49,42,252,0.0
40930.5,829,782,47,43,253,0.0
40942.95,827,779,48,41,252,0.0
40955.54,830,777,53,42,254,0.0
40968.05,830,782,48,41,254,0.0
40980.34,827,779,48,42,252,0.0
40993.08,830,782,48,41,254,0.0
41005.52,828,776,52,42,252,0.0
41018.1,830,782,48,42,254,0.0
41030.52,830,782,48,42,254,0.0
41042.82,827,778,49,41,252,0.0
41055.59,828,781,47,41,253,0.0
41068.07,828,779,49,42,252,0.0333
41080.59,830,781,49,43,254,0.0
41093.02,830,782,48,43,253,0.0
41105.35,827,778,49,42,253,0.0
41118.21,831,782,49,42,254,0.0
41130.64,828,779,49,41,252,0.0
41143.17,831,782,49,42,254,0.0
41155.61,831,782,49,42,253,0.0
41167.88,826,779,47,42,253,0.0
41180.9,830,780,50,42,253,0.0
41193.35,827,779,48,42,252,0.0
41205.96,827,779,48,42,252,0.0
41218.59,830,780,50,43,253,0.0
41231.18,828,779,49,41,252,-0.0333
41244.14,831,784,47,42,253,0.0
41256.57,827,778,49,43,252,0.0
41269.5,830,782,48,42,253,0.0
41281.92,826,779,47,42,253,0.0
41294.28,827,778,49,42,252,0.0
41307.77,830,782,48,42,253,0.0
41320.21,827,779,48,42,252,0.0
41333.44,838,783,55,43,252,0.0
41345.89,827,779,48,42,252,0.0
41358.54,827,778,49,41,252,0.0
41371.8,830,782,48,41,253,0.0
41384.25,827,779,48,42,252,-0.0333
41397.36,831,782,49,42,254,0.0
41409.81,827,778,49,42,253,0.0
41422.36,830,782,48,42,255,0.0
41434.87,830,782,48,42,253,0.0
41447.05,827,778,49,42,253,0.0
41459.89,830,775,55,42,253,0.0
41472.32,826,779,47,43,252,0.0
41484.91,830,782,48,42,254,0.0
41497.46,830,782,48,42,254,0.0
41509.8,827,778,49,43,252,0.0
41522.58,830,782,48,42,253,0.0
41535.01,826,779,47,42,252,0.0
41547.55,831,781,50,42,254,0.0
41560.32,831,781,50,42,254,0.0
41572.61,827,778,49,41,253,0.0
41585.57,831,782,49,42,252,0.0
41598.16,826,778,48,40,252,0.0
41611.11,830,782,48,42,254,0.0
41623.52,826,777,49,42,252,0.0
41635.91,827,777,50,42,252,0.0
41649.55,830,782,48,42,253,0.0
41662.0,828,779,49,42,252,0.0
41675.1,832,779,53,42,253,0.0
41687.55,826,779,47,42,252,0.0
41700.14,825,777,48,42,253,0.0
41713.15,830,781,49,42,254,0.0
41725.49,827,778,49,41,252,0.0
41738.56,830,781,49,42,253,0.0
41751.01,828,779,49,41,252,0.0
41763.57,830,782,48,42,254,0.0
41776.09,830,782,48,42,254,0.0
41788.38,827,778,49,42,253,0.0
41801.16,830,782,48,42,254,0.0
41814.87,827,778,49,42,252,0.0
41827.95,831,781,50,42,253,0.0
41840.36,827,779,48,41,253,0.0
41852.9,827,778,49,42,251,0.0
41866.4,829,782,47,42,254,0.0
41878.81,827,779,48,43,253,0.0
41891.96,828,779,49,41,252,0.0
41904.62,828,779,49,42,253,0.0
41917.26,831,782,49,42,254,0.0
41930.0,831,782,49,42,254,-0.0333
41942.31,827,778,49,42,252,0.0
41955.31,830,782,48,41,254,0.0
41967.79,828,779,49,43,253,0.0
41980.36,830,782,48,42,253,0.0
41992.86,830,782,48,41,253,0.0
42005.18,825,776,49,41,253,0.0
42018.05,829,781,48,42,253,0.0
42030.48,828,779,49,41,252,0.0
42043.03,831,781,50,42,253,0.0
42055.47,830,782,48,41,253,0.0
42067.79,828,779,49,42,252,0.0
42080.59,831,782,49,42,253,0.0
42093.03,827,779,48,42,252,0.0
42105.6,830,782,48,42,254,0.0
42118.16,830,782,48,41,253,-0.0333
42130.41,827,778,49,43,252,0.0
42143.17,829,782,47,43,253,0.0
42155.6,826,779,47,41,253,0.0
42168.2,831,782,49,41,253,0.0
42180.63,831,782,49,41,254,0.0
42192.95,827,778,49,42,253,0.0
42205.73,830,782,48,41,253,0.0
42218.22,826,778,48,42,252,0.0
42230.72,831,783,48,42,254,0.0
42243.16,831,782,49,42,254,0.0
42255.46,824,779,45,43,252,0.0
42268.35,831,782,49,43,253,0.0
42280.8,828,779,49,40,253,0.0
42293.37,831,782,49,42,254,0.0
42305.81,829,784,45,42,254,0.0
42318.12,827,780,47,41,252,0.0
42330.95,831,783,48,42,253,0.0
42343.39,828,780,48,42,252,0.0
42355.92,831,783,48,42,254,0.0
42368.39,831,783,48,42,254,0.0
42380.73,828,779,49,42,253,0.0
42393.52,830,781,49,43,253,0.0
42405.95,827,779,48,41,252,0.0
42418.54,832,783,49,43,254,0.0
42430.98,831,782,49,43,255,0.0
42443.25,829,779,50,42,252,0.0
42456.03,831,782,49,42,254,0.0
42468.49,821,779,42,42,250,0.0
42481.17,831,783,48,42,253,-0.0333
42493.69,831,782,49,42,254,0.0
42505.97,828,779,49,42,253,0.0
42518.79,830,782,48,42,254,0.0
42531.24,828,779,49,41,253,0.0
42543.84,830,783,47,42,253,0.0
42556.29,830,782,48,42,253,0.0
42568.58,828,779,49,42,253,0.0
42581.45,831,782,49,41,254,0.0
42593.95,828,780,48,43,255,0.0
42606.49,831,782,49,43,254,0.0
42619.02,831,783,48,42,254,0.0
42631.28,829,780,49,42,253,0.0
42644.07,831,783,48,42,254,0.0
42656.49,827,780,47,43,253,0.0
42669.1,831,783,48,42,254,0.0
42681.57,831,783,48,42,253,0.0
42693.88,828,780,48,42,253,0.0
42706.66,831,783,48,42,254,0.0
42719.13,828,779,49,41,251,0.0
42731.68,832,783,49,42,253,0.0
42744.13,831,783,48,42,252,0.0
42756.39,827,779,48,42,253,0.0
42769.25,831,782,49,41,254,-0.0333
42781.74,828,780,48,42,252,0.0
42794.26,831,783,48,42,254,0.0
42806.69,829,783,46,42,254,-0.0333
42819.18,826,778,48,41,252,0.0
42832.19,829,782,47,43,252,0.0
42844.68,823,783,40,41,253,0.0
42857.31,829,782,47,41,253,0.0
42869.94,831,782,49,42,254,0.0
42882.43,825,778,47,42,252,0.0
42895.62,830,781,49,42,254,0.0
42908.12,827,779,48,42,252,0.0
42921.16,831,783,48,41,254,0.0
42933.67,829,780,49,42,253,-0.0333
42946.27,827,778,49,42,252,0.0
42959.75,831,783,48,41,253,0.0
42972.17,825,780,45,42,252,0.0
42985.42,832,783,49,41,254,0.0
42997.97,827,779,48,42,253,0.0
43010.58,831,783,48,43,254,0.0
43023.38,831,783,48,43,254,0.0
43035.74,828,779,49,43,252,0.0
43048.64,831,783,48,42,254,0.0
43061.14,828,779,49,41,253,0.0
43073.69,831,783,48,42,254,0.0
43086.22,831,782,49,41,254,0.0
43098.51,823,780,43,41,253,0.0
43111.35,831,783,48,42,253,0.0
43123.85,827,778,49,42,252,0.0
43136.43,832,783,49,43,254,0.0
43148.98,831,783,48,42,254,0.0
43161.36,829,780,49,43,253,0.0
43174.23,830,783,47,42,253,0.0
43186.78,829,780,49,43,255,0.0
43199.39,830,783,47,42,253,-0.0333
43212.48,831,783,48,41,254,0.0
43225.13,825,775,50,42,252,0.0
43238.21,828,780,48,42,253,0.0
43250.94,825,777,48,42,252,0.0
43264.28,829,780,49,42,253,0.0333
43277.41,825,778,47,42,254,0.0
43290.07,821,777,44,42,252,0.0
43302.67,821,778,43,41,253,0.0
43314.62,820,774,46,41,253,0.0
43326.69,819,776,43,42,251,0.0
43339.68,820,776,44,42,251,0.0
43351.69,825,782,43,41,253,0.0
43363.57,825,781,44,42,254,0.0
43375.43,822,778,44,42,252,0.0
43388.09,825,781,44,42,253,0.0
43400.09,825,781,44,41,252,0.0
43411.9,825,782,43,41,254,0.0
43423.95,824,781,43,42,253,0.0
43435.7,822,777,45,41,252,0.0
43448.39,824,782,42,42,253,0.0
43460.29,824,782,42,41,253,0.0
43472.56,820,776,44,42,252,0.0
43485.17,824,781,43,41,253,0.0
43496.91,820,776,44,41,252,0.0
43509.16,825,781,44,41,253,0.0
43521.0,824,780,44,42,253,0.0
43532.88,820,778,42,41,251,0.0
43545.25,825,781,44,42,253,0.0
43557.09,819,777,42,41,251,0.0
43569.05,825,782,43,41,253,0.0
43580.88,824,781,43,41,253,0.0
43592.69,820,777,43,41,251,0.0
43605.02,825,781,44,42,253,0.0
43616.97,820,776,44,42,252,0.0
43628.85,825,782,43,42,254,0.0
43640.67,825,781,44,42,253,0.0
43652.4,822,778,44,43,252,0.0
43664.98,825,781,44,42,252,0.0
43676.83,824,782,42,42,253,0.0
43688.57,820,777,43,42,251,0.0
43701.69,825,781,44,41,253,0.0
43713.42,820,776,44,40,251,0.0
43725.63,827,780,47,42,253,0.0
43737.51,824,782,42,42,253,0.0
43749.2,820,777,43,42,252,0.0
43762.17,825,782,43,42,253,0.0
43773.98,819,776,43,41,252,0.0
43785.9,825,779,46,42,253,0.0
43797.78,825,781,44,42,253,0.0
43809.55,819,777,42,42,252,0.0
43821.79,825,781,44,42,253,0.0
43833.92,820,776,44,41,251,0.0
43845.79,826,782,44,41,252,0.0
43857.64,824,781,43,41,253,0.0
43869.43,821,777,44,42,252,0.0
43881.73,825,781,44,41,253,0.0
43893.58,825,782,43,42,252,0.0
43905.82,826,780,46,42,253,0.0
43917.73,825,781,44,42,253,0.0
43929.39,821,777,44,41,252,0.0
43943.44,821,781,40,42,254,0.0
43955.65,821,777,44,40,252,0.0
43967.52,825,781,44,42,253,0.0
